gameId,blueWins,blueWardsPlaced,blueWardsDestroyed,blueFirstBlood,blueKills,blueDeaths,blueAssists,blueEliteMonsters,blueDragons,blueHeralds,blueTowersDestroyed,blueTotalGold,blueAvgLevel,blueTotalExperience,blueTotalMinionsKilled,blueTotalJungleMinionsKilled,blueGoldDiff,blueExperienceDiff,blueCSPerMin,blueGoldPerMin,redWardsPlaced,redWardsDestroyed,redFirstBlood,redKills,redDeaths,redAssists,redEliteMonsters,redDragons,redHeralds,redTowersDestroyed,redTotalGold,redAvgLevel,redTotalExperience,redTotalMinionsKilled,redTotalJungleMinionsKilled,redGoldDiff,redExperienceDiff,redCSPerMin,redGoldPerMin
4510664685,0,13,5,1,5,6,5,0,0,0,0,16312,7.0,18684,239,41,-77,260,23.9,1631.2,97,2,0,6,5,11,1,1,0,0,16389,7.0,18424,230,42,77,-260,23.0,1638.9
4482120064,0,17,1,0,3,7,3,0,0,0,0,15015,6.8,16974,209,53,-1996,-1804,20.9,1501.5,18,3,1,7,3,13,0,0,0,0,17011,7.2,18778,237,51,1996,1804,23.7,1701.1
4500245820,0,14,2,1,8,6,6,1,1,0,0,16706,6.8,17561,216,36,31,-741,21.6,1670.6,16,2,0,6,8,7,1,0,1,0,16675,7.0,18302,231,52,-31,741,23.1,1667.5
4462971109,0,15,0,0,4,7,4,0,0,0,0,15317,7.0,18310,225,56,-1742,-357,22.5,1531.7,26,4,1,7,4,7,1,1,0,0,17059,6.8,18667,221,67,1742,357,22.1,1705.9
4523608047,0,16,1,0,4,7,2,0,0,0,0,16224,7.0,18247,212,64,-294,321,21.2,1622.4,13,4,1,7,4,5,0,0,0,0,16518,7.0,17926,205,40,294,-321,20.5,1651.8
4445820546,0,12,2,0,5,22,4,0,0,0,0,15077,6.4,15707,138,52,-7278,-6021,13.8,1507.7,14,1,1,22,5,12,0,0,0,0,22355,8.0,21728,229,36,7278,6021,22.9,2235.5
4473787682,0,16,4,1,8,7,8,0,0,0,0,17415,6.8,18304,239,48,1158,-618,23.9,1741.5,17,3,0,7,8,4,1,1,0,0,16257,7.2,18922,184,84,-1158,618,18.4,1625.7
4451694219,0,24,0,0,1,5,0,0,0,0,0,14824,7.2,18421,230,72,-1424,-2416,23.0,1482.4,14,2,1,5,1,3,1,1,0,0,16248,7.6,20837,228,68,1424,2416,22.8,1624.8
4510563287,0,11,1,0,8,10,8,0,0,0,0,16239,7.0,17518,186,48,-1289,-1384,18.6,1623.9,16,2,1,10,8,8,1,1,0,0,17528,7.0,18902,204,53,1289,1384,20.4,1752.8
4479510893,0,49,2,1,8,8,14,0,0,0,0,17346,6.8,16570,191,41,1399,1293,19.1,1734.6,21,5,0,8,8,14,0,0,0,0,15947,6.2,15277,193,34,-1399,-1293,19.3,1594.7
4522659821,0,15,3,0,1,3,2,0,0,0,0,14114,6.8,17618,229,55,-1313,-6,22.9,1411.4,18,2,1,3,1,5,2,1,1,0,15427,6.8,17624,250,48,1313,6,25.0,1542.7
4480172739,0,40,6,0,4,9,3,0,0,0,0,15469,6.6,17314,234,45,-2472,-554,23.4,1546.9,18,7,1,9,4,8,2,1,1,0,17941,6.8,17868,227,68,2472,554,22.7,1794.1
4518506408,0,14,3,1,8,5,4,1,0,1,1,17951,7.2,18661,244,50,2114,1904,24.4,1795.1,18,3,0,5,8,4,1,1,0,0,15837,6.4,16757,220,56,-2114,-1904,22.0,1583.7
4452601584,0,13,27,0,9,7,7,0,0,0,0,18012,7.0,19569,239,41,1194,2051,23.9,1801.2,45,4,1,7,9,6,1,1,0,0,16818,6.6,17518,221,42,-1194,-2051,22.1,1681.8
4523418547,0,12,1,0,3,8,2,0,0,0,0,14585,6.6,16310,225,38,-1321,-274,22.5,1458.5,11,0,1,8,3,4,2,1,1,0,15906,6.8,16584,185,64,1321,274,18.5,1590.6
4518222649,0,14,4,0,5,5,5,1,0,1,0,16115,7.2,18971,237,48,516,2485,23.7,1611.5,19,2,1,5,5,8,0,0,0,0,15599,6.6,16486,213,42,-516,-2485,21.3,1559.9
4523105841,0,11,3,0,2,11,1,1,1,0,0,14643,6.8,17019,230,56,-4728,-3668,23.0,1464.3,28,4,1,11,2,14,0,0,0,0,19371,7.6,20687,236,64,4728,3668,23.6,1937.1
4514715647,0,57,3,0,2,6,1,0,0,0,0,14230,6.6,17035,232,39,-2647,-1872,23.2,1423.0,16,1,1,6,2,6,2,1,1,0,16877,7.0,18907,254,69,2647,1872,25.4,1687.7
4513996335,0,41,3,1,7,7,7,1,1,0,0,16491,6.6,16774,190,60,453,-1745,19.0,1649.1,16,6,0,7,7,0,0,0,0,0,16038,7.0,18519,238,51,-453,1745,23.8,1603.8
4479932808,0,15,3,0,1,3,1,0,0,0,0,13638,6.8,16479,190,59,-2033,-1612,19.0,1363.8,19,3,1,3,1,3,0,0,0,0,15671,7.2,18091,238,47,2033,1612,23.8,1567.1
4519356539,0,38,4,1,3,0,3,0,0,0,0,15984,6.8,18306,261,49,1916,632,26.1,1598.4,16,0,0,0,3,0,0,0,0,0,14068,6.8,17674,224,72,-1916,-632,22.4,1406.8
4516262815,0,28,4,1,4,7,6,0,0,0,0,14937,6.8,16417,211,57,-2601,-3694,21.1,1493.7,15,5,0,7,4,8,2,1,1,0,17538,7.4,20111,232,60,2601,3694,23.2,1753.8
4501779329,0,16,4,1,6,5,7,1,0,1,0,16113,6.8,16994,180,41,-1063,-632,18.0,1611.3,18,4,0,5,6,5,0,0,0,1,17176,6.8,17626,240,41,1063,632,24.0,1717.6
4494430397,0,32,3,1,5,9,3,0,0,0,0,15761,6.8,16587,200,36,-1632,-1461,20.0,1576.1,13,7,0,9,5,7,0,0,0,0,17393,7.0,18048,212,28,1632,1461,21.2,1739.3
4513892324,0,14,2,0,7,12,8,0,0,0,0,16804,6.6,16732,184,52,-1072,-646,18.4,1680.4,12,3,1,12,7,16,0,0,0,0,17876,7.0,17378,194,24,1072,646,19.4,1787.6
4525539438,0,17,2,0,5,11,3,0,0,0,0,15645,6.8,16821,203,42,-2328,-1524,20.3,1564.5,18,3,1,11,5,13,1,1,0,0,17973,6.8,18345,209,40,2328,1524,20.9,1797.3
4525041896,0,13,3,0,3,10,2,1,1,0,0,14995,6.6,16206,210,53,-3685,-3119,21.0,1499.5,20,3,1,10,3,13,1,0,1,0,18680,7.4,19325,200,67,3685,3119,20.0,1868.0
4524058240,0,41,3,0,1,6,2,1,1,0,0,14165,6.8,17829,218,59,-1963,-45,21.8,1416.5,19,2,1,6,1,7,0,0,0,0,16128,7.0,17874,205,52,1963,45,20.5,1612.8
4519023406,0,15,14,0,9,6,10,0,0,0,0,17666,6.4,17054,195,50,846,-28,19.5,1766.6,37,2,1,6,9,8,0,0,0,0,16820,6.8,17082,247,40,-846,28,24.7,1682.0
4519461793,0,18,1,0,4,7,7,0,0,0,0,15818,6.8,17864,233,47,-60,1347,23.3,1581.8,62,3,1,7,4,13,1,1,0,0,15878,6.6,16517,186,36,60,-1347,18.6,1587.8
4526640104,0,38,0,1,4,14,2,0,0,0,0,14963,6.2,15662,170,48,-6047,-3060,17.0,1496.3,19,4,0,14,4,20,2,1,1,1,21010,7.0,18722,203,41,6047,3060,20.3,2101.0
4489658562,0,12,2,1,10,16,10,1,0,1,0,18145,6.6,17219,199,46,-3228,-2075,19.9,1814.5,14,4,0,16,10,13,1,1,0,0,21373,7.2,19294,237,38,3228,2075,23.7,2137.3
4526750578,0,36,4,0,7,10,8,0,0,0,0,15265,6.0,14533,161,28,-2627,-2458,16.1,1526.5,18,2,1,10,7,16,0,0,0,0,17892,6.6,16991,218,37,2627,2458,21.8,1789.2
4491027419,0,21,5,0,3,4,2,1,0,1,0,15759,7.0,17815,245,53,-183,-779,24.5,1575.9,114,6,1,4,3,3,1,1,0,0,15942,7.4,18594,230,64,183,779,23.0,1594.2
4524806566,0,15,2,0,6,13,9,0,0,0,0,16291,6.6,16699,191,38,-3622,-2561,19.1,1629.1,146,2,1,13,6,12,0,0,0,0,19913,7.0,19260,223,39,3622,2561,22.3,1991.3
4510955458,0,12,4,1,3,8,2,0,0,0,0,14783,6.2,15957,206,50,-1905,-2223,20.6,1478.3,18,3,0,8,3,5,1,1,0,0,16688,7.0,18180,224,60,1905,2223,22.4,1668.8
4521770795,0,13,4,0,2,7,1,0,0,0,0,14573,6.8,17827,212,58,-2928,-1796,21.2,1457.3,15,1,1,7,2,8,2,1,1,0,17501,7.2,19623,239,55,2928,1796,23.9,1750.1
4509935762,0,39,4,0,7,11,6,0,0,0,0,16513,7.0,17530,197,44,-1696,-1187,19.7,1651.3,19,0,1,11,7,12,1,1,0,0,18209,7.2,18717,218,53,1696,1187,21.8,1820.9
4523258909,0,57,3,1,8,7,5,0,0,0,0,16204,6.6,17473,184,47,-1016,-1306,18.4,1620.4,17,4,0,7,8,7,1,1,0,0,17220,7.0,18779,210,51,1016,1306,21.0,1722.0
4518019650,0,11,4,1,3,5,3,0,0,0,0,15029,7.0,17571,230,40,-1420,-1415,23.0,1502.9,103,1,0,5,3,5,1,1,0,0,16449,7.0,18986,222,56,1420,1415,22.2,1644.9
4510818767,0,16,1,1,4,10,4,0,0,0,0,16256,6.8,17776,248,57,-2528,-2509,24.8,1625.6,16,4,0,10,4,15,2,1,1,0,18784,7.6,20285,221,58,2528,2509,22.1,1878.4
4522629457,0,35,1,0,3,9,0,0,0,0,0,14149,6.6,17085,189,49,-3960,-2533,18.9,1414.9,12,1,1,9,3,9,0,0,0,0,18109,7.2,19618,220,52,3960,2533,22.0,1810.9
4516600859,0,18,1,1,4,1,4,1,0,1,1,16808,6.8,17831,227,46,2476,772,22.7,1680.8,15,2,0,1,4,0,1,1,0,0,14332,6.8,17059,248,53,-2476,-772,24.8,1433.2
4486292796,0,12,2,0,7,11,4,0,0,0,0,15528,6.6,17206,235,6,-3546,-1919,23.5,1552.8,14,0,1,11,7,12,0,0,0,0,19074,7.2,19125,238,65,3546,1919,23.8,1907.4
4522545565,0,15,1,0,1,6,1,0,0,0,0,14555,6.8,17217,239,48,-1824,-613,23.9,1455.5,19,3,1,6,1,6,1,0,1,0,16379,7.0,17830,204,55,1824,613,20.4,1637.9
4519552784,0,21,4,1,11,9,10,1,1,0,0,18172,6.8,17184,191,36,1390,437,19.1,1817.2,15,1,0,9,11,7,0,0,0,0,16782,6.6,16747,181,30,-1390,-437,18.1,1678.2
4517748095,0,14,1,0,5,14,6,2,1,1,0,15015,6.6,16032,167,54,-5065,-3552,16.7,1501.5,16,1,1,14,5,9,0,0,0,0,20080,7.4,19584,224,52,5065,3552,22.4,2008.0
4469393783,0,29,3,0,5,9,7,0,0,0,0,15831,6.6,17389,208,59,-2241,-1888,20.8,1583.1,15,2,1,9,5,13,2,1,1,0,18072,7.2,19277,218,52,2241,1888,21.8,1807.2
4499920365,0,13,4,1,9,5,8,0,0,0,0,18096,7.2,18969,232,36,2526,1379,23.2,1809.6,16,2,0,5,9,4,1,1,0,0,15570,6.8,17590,194,49,-2526,-1379,19.4,1557.0
4526866944,0,17,3,1,7,4,12,1,1,0,0,17199,7.0,19299,229,59,1545,1417,22.9,1719.9,16,2,0,4,7,5,0,0,0,0,15654,7.2,17882,226,53,-1545,-1417,22.6,1565.4
4519881669,0,23,4,1,3,8,6,1,0,1,1,15698,6.4,16251,189,47,-1838,-1430,18.9,1569.8,68,4,0,8,3,9,1,1,0,0,17536,6.8,17681,211,58,1838,1430,21.1,1753.6
4489369709,0,17,4,1,7,6,6,0,0,0,0,16457,7.0,18265,202,56,265,-267,20.2,1645.7,16,4,0,6,7,4,1,1,0,0,16192,7.0,18532,234,63,-265,267,23.4,1619.2
4513242798,0,16,3,1,7,4,4,0,0,0,0,16589,7.0,18105,231,49,-17,-355,23.1,1658.9,18,2,0,4,7,4,1,1,0,0,16606,7.2,18460,220,66,17,355,22.0,1660.6
4521571856,0,17,4,1,5,3,6,1,1,0,0,16695,7.2,19112,257,56,1551,1481,25.7,1669.5,14,2,0,3,5,3,0,0,0,0,15144,6.8,17631,224,52,-1551,-1481,22.4,1514.4
4525314215,0,16,2,1,5,4,2,0,0,0,0,15372,7.0,17632,228,48,-443,-732,22.8,1537.2,44,5,0,4,5,3,0,0,0,0,15815,7.2,18364,237,56,443,732,23.7,1581.5
4461471902,0,19,1,1,2,7,3,0,0,0,0,14711,6.6,16207,221,45,-2625,-3375,22.1,1471.1,15,3,0,7,2,5,1,1,0,0,17336,7.6,19582,244,66,2625,3375,24.4,1733.6
4460445038,0,34,0,0,5,7,3,1,0,1,0,16616,7.0,18633,211,67,-47,318,21.1,1661.6,11,4,1,7,5,10,1,1,0,0,16663,7.0,18315,219,56,47,-318,21.9,1666.3
4524619949,0,14,3,0,3,10,4,0,0,0,0,14742,6.6,15941,215,52,-3540,-3279,21.5,1474.2,21,0,1,10,3,13,1,1,0,0,18282,7.2,19220,227,44,3540,3279,22.7,1828.2
4497727067,0,17,3,0,3,5,2,0,0,0,0,15195,7.0,17434,226,61,-713,-653,22.6,1519.5,17,3,1,5,3,6,1,1,0,0,15908,7.0,18087,232,54,713,653,23.2,1590.8
4501013460,0,27,0,0,6,10,4,1,0,1,0,16171,7.0,17902,202,54,-1682,-71,20.2,1617.1,14,2,1,10,6,8,1,1,0,0,17853,7.0,17973,226,52,1682,71,22.6,1785.3
4524348697,0,19,1,0,6,5,3,1,0,1,0,16141,7.4,19201,215,58,488,2349,21.5,1614.1,16,3,1,5,6,9,1,1,0,0,15653,6.6,16852,183,44,-488,-2349,18.3,1565.3
4498735941,0,14,1,0,7,8,8,1,0,1,0,17127,7.0,17974,243,45,-373,-212,24.3,1712.7,19,2,1,8,7,10,1,1,0,0,17500,7.0,18186,229,47,373,212,22.9,1750.0
4526126466,0,15,0,1,5,6,5,1,0,1,1,18041,7.0,17904,229,52,1197,-947,22.9,1804.1,22,2,0,6,5,7,1,1,0,0,16844,7.4,18851,224,58,-1197,947,22.4,1684.4
4519404652,0,22,1,1,7,6,6,0,0,0,0,16420,6.8,17929,209,55,-514,-1465,20.9,1642.0,36,3,0,6,7,9,1,1,0,0,16934,7.2,19394,236,68,514,1465,23.6,1693.4
4524068171,0,18,3,1,9,6,8,0,0,0,0,16961,6.6,17237,191,48,531,-881,19.1,1696.1,17,2,0,6,9,13,1,1,0,0,16430,7.2,18118,198,60,-531,881,19.8,1643.0
4516913135,0,15,2,0,5,14,3,0,0,0,0,15424,6.8,17248,191,35,-4585,-3125,19.1,1542.4,15,4,1,14,5,13,2,1,1,0,20009,7.4,20373,228,56,4585,3125,22.8,2000.9
4523059418,0,19,1,1,10,8,12,1,0,1,0,17552,7.2,18284,222,39,1050,-1270,22.2,1755.2,35,2,0,8,10,5,1,1,0,0,16502,7.4,19554,192,46,-1050,1270,19.2,1650.2
4518753838,0,14,1,1,5,3,5,0,0,0,0,15892,6.8,18043,216,48,822,25,21.6,1589.2,13,1,0,3,5,3,2,1,1,0,15070,7.2,18018,229,55,-822,-25,22.9,1507.0
4455245413,0,14,1,1,5,10,4,0,0,0,0,15985,6.8,17576,223,47,-974,-1978,22.3,1598.5,13,3,0,10,5,11,1,1,0,0,16959,7.2,19554,188,37,974,1978,18.8,1695.9
4480691713,0,13,5,0,5,7,4,0,0,0,0,15132,6.6,17149,196,44,-1740,-916,19.6,1513.2,20,3,1,7,5,8,1,1,0,0,16872,6.8,18065,230,56,1740,916,23.0,1687.2
4517062497,0,17,0,0,5,8,2,0,0,0,0,15334,7.0,18085,204,63,-2564,-35,20.4,1533.4,101,3,1,8,5,12,0,0,0,0,17898,7.0,18120,227,44,2564,35,22.7,1789.8
4479732841,0,26,3,0,4,6,5,0,0,0,0,15554,7.0,18372,242,52,-1232,-1020,24.2,1555.4,16,1,1,6,4,5,1,1,0,0,16786,7.4,19392,230,52,1232,1020,23.0,1678.6
4483111734,0,13,1,0,3,6,3,0,0,0,0,14647,7.2,17841,185,68,-2084,-851,18.5,1464.7,15,0,1,6,3,6,2,1,1,0,16731,7.0,18692,251,40,2084,851,25.1,1673.1
4524019203,0,19,4,0,8,5,9,0,0,0,0,18098,7.2,19504,212,76,2730,3068,21.2,1809.8,19,2,1,5,8,2,1,1,0,0,15368,6.4,16436,215,40,-2730,-3068,21.5,1536.8
4523992851,0,15,1,1,4,6,4,0,0,0,0,15865,7.0,18437,238,59,-418,34,23.8,1586.5,15,2,0,6,4,8,1,1,0,0,16283,7.0,18403,231,52,418,-34,23.1,1628.3
4448447768,0,10,1,0,10,15,8,0,0,0,0,17418,7.0,18495,202,38,-2298,-1255,20.2,1741.8,14,1,1,15,10,10,1,1,0,0,19716,7.2,19750,171,46,2298,1255,17.1,1971.6
4468676047,0,13,2,1,6,9,7,2,1,1,0,15928,6.4,16033,173,67,-1885,-1025,17.3,1592.8,12,0,0,9,6,10,0,0,0,0,17813,6.8,17058,233,17,1885,1025,23.3,1781.3
4460890614,0,12,5,1,7,4,8,0,0,0,0,17062,7.2,19299,238,58,1922,1870,23.8,1706.2,19,2,0,4,7,4,0,0,0,0,15140,6.8,17429,191,44,-1922,-1870,19.1,1514.0
4520687269,0,63,6,0,9,4,5,0,0,0,0,18184,7.4,20169,238,52,2989,4519,23.8,1818.4,23,18,1,4,9,6,0,0,0,0,15195,6.4,15650,192,44,-2989,-4519,19.2,1519.5
4513442931,0,40,4,1,7,5,9,0,0,0,0,17003,6.6,18007,214,40,1331,1287,21.4,1700.3,16,1,0,5,7,8,0,0,0,0,15672,6.8,16720,190,52,-1331,-1287,19.0,1567.2
4519875448,0,21,5,1,6,5,14,1,1,0,0,16986,7.0,17323,231,55,313,-1776,23.1,1698.6,16,8,0,5,6,3,1,0,1,0,16673,7.2,19099,236,56,-313,1776,23.6,1667.3
4473216293,0,102,0,0,2,10,1,0,0,0,0,13456,6.6,16144,164,50,-5199,-3608,16.4,1345.6,16,2,1,10,2,8,1,1,0,0,18655,7.4,19752,245,47,5199,3608,24.5,1865.5
4523641234,0,18,1,0,6,8,6,1,1,0,0,16029,6.8,17293,198,48,-1350,-1765,19.8,1602.9,12,3,1,8,6,6,0,0,0,0,17379,7.2,19058,206,51,1350,1765,20.6,1737.9
4526992864,0,16,1,1,6,4,11,0,0,0,0,16324,6.8,17601,197,47,541,875,19.7,1632.4,11,6,0,4,6,3,0,0,0,0,15783,6.8,16726,240,44,-541,-875,24.0,1578.3
4499304151,0,43,5,1,8,2,11,1,1,0,0,17554,7.2,19243,204,51,3255,1724,20.4,1755.4,17,1,0,2,8,1,0,0,0,0,14299,6.8,17519,211,46,-3255,-1724,21.1,1429.9
4496877385,0,18,2,1,9,8,9,1,1,0,0,18096,6.8,17875,213,48,1827,972,21.3,1809.6,18,4,0,8,9,14,1,0,1,0,16269,6.8,16903,167,56,-1827,-972,16.7,1626.9
4508656599,0,13,1,0,3,5,4,0,0,0,0,14815,6.4,16969,221,42,-2541,-1921,22.1,1481.5,8,2,1,5,3,3,2,1,1,1,17356,7.0,18890,237,61,2541,1921,23.7,1735.6
4497858921,0,15,2,1,5,4,4,0,0,0,0,15634,6.8,16355,201,45,71,-359,20.1,1563.4,14,1,0,4,5,4,1,1,0,0,15563,6.8,16714,222,38,-71,359,22.2,1556.3
4486160462,0,14,0,1,3,2,3,1,0,1,0,14424,6.6,17499,201,48,-541,-66,20.1,1442.4,9,0,0,2,3,2,0,0,0,0,14965,6.8,17565,234,60,541,66,23.4,1496.5
4478267936,0,16,3,0,6,5,7,0,0,0,0,17065,7.0,18634,220,50,1019,327,22.0,1706.5,18,1,1,5,6,7,1,1,0,0,16046,7.0,18307,233,50,-1019,-327,23.3,1604.6
4467214068,0,90,8,0,2,10,2,1,0,1,0,14519,6.8,17122,223,40,-3798,-2950,22.3,1451.9,45,5,1,10,2,13,1,1,0,0,18317,7.4,20072,226,64,3798,2950,22.6,1831.7
4473660797,0,15,0,0,10,9,13,2,1,1,0,17145,7.0,17904,192,45,-1464,-454,19.2,1714.5,15,3,1,9,10,5,0,0,0,0,18609,7.2,18358,226,46,1464,454,22.6,1860.9
4523735052,0,15,2,0,3,8,2,0,0,0,0,14478,6.6,16879,205,44,-2153,-2381,20.5,1447.8,88,0,1,8,3,8,2,1,1,0,16631,7.2,19260,215,52,2153,2381,21.5,1663.1
4497099523,0,58,2,0,9,10,10,2,1,1,0,18368,7.2,19062,204,52,-328,137,20.4,1836.8,14,1,1,10,9,13,0,0,0,0,18696,7.2,18925,230,52,328,-137,23.0,1869.6
4410192659,0,13,1,0,6,8,6,0,0,0,0,15883,6.8,16480,228,28,-791,-2157,22.8,1588.3,17,0,1,8,6,7,0,0,0,0,16674,6.8,18637,213,48,791,2157,21.3,1667.4
4487337497,0,13,1,1,6,5,9,1,1,0,0,16995,7.0,18679,230,64,930,567,23.0,1699.5,18,2,0,5,6,3,0,0,0,0,16065,7.0,18112,221,43,-930,-567,22.1,1606.5
4451057396,0,16,2,1,6,7,5,1,0,1,0,15905,7.0,17754,200,52,-1317,-1427,20.0,1590.5,12,3,0,7,6,10,1,1,0,0,17222,7.2,19181,203,67,1317,1427,20.3,1722.2
4518579110,0,19,3,1,9,7,8,0,0,0,0,19087,7.2,19779,250,60,2350,1981,25.0,1908.7,17,5,0,7,9,7,1,1,0,0,16737,7.0,17798,216,42,-2350,-1981,21.6,1673.7
4517934356,0,83,4,1,5,9,3,0,0,0,0,16259,6.4,16804,224,43,-1501,-2063,22.4,1625.9,39,4,0,9,5,7,1,1,0,0,17760,7.2,18867,240,60,1501,2063,24.0,1776.0
4524151765,0,13,2,1,8,5,5,1,1,0,0,16373,7.0,18169,188,47,1221,494,18.8,1637.3,11,2,0,5,8,4,0,0,0,0,15152,7.0,17675,209,40,-1221,-494,20.9,1515.2
4501133727,0,18,5,0,3,7,5,0,0,0,0,14996,6.4,16234,221,44,-1502,-959,22.1,1499.6,17,4,1,7,3,13,0,0,0,0,16498,6.8,17193,229,48,1502,959,22.9,1649.8
4439065205,0,28,3,0,6,9,9,0,0,0,0,16552,7.0,17597,215,48,-1026,-982,21.5,1655.2,19,3,1,9,6,7,1,1,0,0,17578,7.0,18579,234,52,1026,982,23.4,1757.8
4520305649,0,14,2,0,3,8,3,0,0,0,0,14275,6.4,15474,180,56,-3414,-3747,18.0,1427.5,14,2,1,8,3,4,2,1,1,0,17689,7.2,19221,228,60,3414,3747,22.8,1768.9
4510530243,0,16,3,0,6,5,9,1,1,0,0,16110,7.0,17501,206,36,72,-81,20.6,1611.0,12,5,1,5,6,5,0,0,0,0,16038,6.8,17582,217,59,-72,81,21.7,1603.8
4472346713,0,13,1,1,5,5,0,0,0,0,0,15850,7.0,18559,216,52,144,312,21.6,1585.0,16,1,0,5,5,4,1,1,0,0,15706,7.2,18247,238,56,-144,-312,23.8,1570.6
4511396736,0,19,1,0,4,6,5,1,0,1,0,14939,6.6,15632,189,51,-798,-1418,18.9,1493.9,11,3,1,6,4,13,1,1,0,0,15737,6.8,17050,210,50,798,1418,21.0,1573.7
4519000412,0,40,2,0,1,7,0,0,0,0,0,12300,6.0,14201,171,30,-5394,-5037,17.1,1230.0,18,16,1,7,1,8,2,1,1,0,17694,7.2,19238,246,54,5394,5037,24.6,1769.4
4379661286,0,16,1,0,5,9,3,1,1,0,0,15101,6.4,16888,187,48,-3014,-357,18.7,1510.1,23,5,1,9,5,13,0,0,0,0,18115,6.6,17245,252,49,3014,357,25.2,1811.5
4492860454,0,15,2,0,9,3,12,0,0,0,0,17892,7.2,18969,215,56,1873,883,21.5,1789.2,16,1,1,3,9,2,1,1,0,0,16019,7.0,18086,249,56,-1873,-883,24.9,1601.9
4436047173,0,17,1,1,9,6,11,0,0,0,0,17416,7.2,18429,208,44,-367,-1771,20.8,1741.6,13,4,0,6,9,6,1,1,0,0,17783,7.4,20200,243,68,367,1771,24.3,1778.3
4467685567,0,40,0,0,2,8,2,0,0,0,0,14200,6.6,17304,191,52,-3805,-2093,19.1,1420.0,15,2,1,8,2,9,1,1,0,0,18005,7.0,19397,230,60,3805,2093,23.0,1800.5
4527028383,0,92,3,1,3,6,0,1,1,0,0,14746,6.8,17610,206,56,-1108,-370,20.6,1474.6,16,1,0,6,3,6,0,0,0,0,15854,7.0,17980,210,52,1108,370,21.0,1585.4
4525772082,0,19,6,0,2,8,2,1,0,1,0,14970,6.8,17809,235,59,-2366,-340,23.5,1497.0,21,4,1,8,2,14,0,0,0,0,17336,6.8,18149,226,34,2366,340,22.6,1733.6
4469945673,0,69,5,0,3,8,4,0,0,0,0,14108,6.4,16327,188,48,-4316,-2717,18.8,1410.8,18,6,1,8,3,7,2,1,1,0,18424,7.4,19044,262,64,4316,2717,26.2,1842.4
4526051141,0,13,5,0,6,9,3,0,0,0,0,15450,6.8,17448,207,31,-1989,-1299,20.7,1545.0,16,0,1,9,6,9,0,0,0,0,17439,7.2,18747,213,36,1989,1299,21.3,1743.9
4503402454,0,18,3,1,11,8,15,0,0,0,0,18923,7.0,18843,225,68,1744,454,22.5,1892.3,16,2,0,8,11,7,1,0,1,0,17179,7.0,18389,219,48,-1744,-454,21.9,1717.9
4449354276,0,14,3,1,9,7,11,0,0,0,0,17382,7.2,19283,220,55,1103,1117,22.0,1738.2,41,3,0,7,9,10,0,0,0,0,16279,7.2,18166,209,36,-1103,-1117,20.9,1627.9
4526491541,0,17,5,1,8,8,11,1,1,0,0,17399,7.0,17937,245,44,381,865,24.5,1739.9,18,2,0,8,8,9,0,0,0,0,17018,6.4,17072,237,36,-381,-865,23.7,1701.8
4491959967,0,14,0,1,9,9,6,0,0,0,0,17384,6.8,18722,227,48,-898,-939,22.7,1738.4,12,0,0,9,9,9,2,1,1,0,18282,7.2,19661,225,56,898,939,22.5,1828.2
4516351338,0,30,0,0,4,7,2,1,0,1,1,17040,7.2,18774,228,76,293,718,22.8,1704.0,15,1,1,7,4,7,1,1,0,0,16747,6.8,18056,204,56,-293,-718,20.4,1674.7
4508384732,0,17,0,1,10,5,8,0,0,0,0,17403,7.0,18532,181,40,1515,1112,18.1,1740.3,16,5,0,5,10,7,1,1,0,0,15888,7.0,17420,231,44,-1515,-1112,23.1,1588.8
4514106633,0,15,2,1,5,5,5,0,0,0,0,15734,7.0,17911,213,47,-837,-660,21.3,1573.4,21,3,0,5,5,7,2,1,1,0,16571,7.0,18571,249,47,837,660,24.9,1657.1
4521245361,0,16,3,1,2,10,1,0,0,0,0,13544,6.2,15367,206,18,-5820,-4066,20.6,1354.4,15,2,0,10,2,8,0,0,0,0,19364,7.2,19433,255,77,5820,4066,25.5,1936.4
4511713193,0,13,4,0,2,6,2,1,1,0,0,14596,6.8,17298,204,81,-1883,-1131,20.4,1459.6,16,2,1,6,2,2,0,0,0,0,16479,6.8,18429,254,43,1883,1131,25.4,1647.9
4418034282,0,17,3,0,3,3,3,0,0,0,0,15603,6.8,18354,239,72,288,-339,23.9,1560.3,21,5,1,3,3,2,0,0,0,0,15315,7.0,18693,232,52,-288,339,23.2,1531.5
4472568378,0,15,3,0,1,6,0,0,0,0,0,13921,6.6,16963,207,56,-2641,-2207,20.7,1392.1,16,3,1,6,1,5,1,0,1,0,16562,7.0,19170,242,44,2641,2207,24.2,1656.2
4514375184,0,14,4,0,2,6,2,1,1,0,0,15300,7.0,18001,266,53,-978,-849,26.6,1530.0,17,2,1,6,2,8,0,0,0,0,16278,7.0,18850,228,48,978,849,22.8,1627.8
4526401078,0,11,1,0,4,3,3,1,1,0,0,15080,7.0,18378,208,56,-401,-439,20.8,1508.0,37,1,1,3,4,3,0,0,0,0,15481,7.4,18817,232,53,401,439,23.2,1548.1
4508218503,0,14,1,0,0,1,0,0,0,0,0,14713,7.0,17547,261,53,-388,-1004,26.1,1471.3,10,4,1,1,0,1,1,1,0,0,15101,7.0,18551,264,56,388,1004,26.4,1510.1
4519408439,0,89,1,0,5,7,5,0,0,0,0,15856,7.0,18029,224,44,295,630,22.4,1585.6,15,2,1,7,5,6,0,0,0,0,15561,6.8,17399,173,51,-295,-630,17.3,1556.1
4512194286,0,14,1,0,3,8,1,0,0,0,0,15539,6.8,17792,214,72,-2925,-2112,21.4,1553.9,20,3,1,8,3,9,2,1,1,0,18464,7.2,19904,242,47,2925,2112,24.2,1846.4
4451815027,0,13,5,0,5,4,8,0,0,0,0,16059,7.0,18553,216,48,-1694,-1,21.6,1605.9,22,6,1,4,5,5,2,1,1,1,17753,7.2,18554,231,52,1694,1,23.1,1775.3
4524848216,0,35,3,0,6,8,4,0,0,0,0,15589,6.6,16619,181,40,-1535,-2054,18.1,1558.9,38,1,1,8,6,10,1,0,1,0,17124,7.0,18673,210,56,1535,2054,21.0,1712.4
4520555192,0,40,1,0,2,9,1,1,1,0,0,14478,6.6,16901,237,48,-3613,-1592,23.7,1447.8,13,2,1,9,2,9,0,0,0,0,18091,7.0,18493,232,52,3613,1592,23.2,1809.1
4489343970,0,15,1,0,3,5,2,0,0,0,0,16102,7.2,19258,257,66,-281,110,25.7,1610.2,13,3,1,5,3,4,1,1,0,0,16383,7.0,19148,251,50,281,-110,25.1,1638.3
4475861894,0,18,10,1,2,5,3,1,1,0,0,15158,6.8,17387,250,43,-627,183,25.0,1515.8,45,8,0,5,2,9,0,0,0,0,15785,6.8,17204,243,24,627,-183,24.3,1578.5
4522526213,0,13,3,0,3,7,2,0,0,0,0,15692,7.0,17807,234,55,-560,476,23.4,1569.2,12,4,1,7,3,4,1,1,0,0,16252,6.8,17331,199,56,560,-476,19.9,1625.2
4481184386,0,50,1,0,6,8,9,0,0,0,0,16145,6.8,17448,215,44,-1962,-684,21.5,1614.5,16,4,1,8,6,12,0,0,0,0,18107,7.0,18132,223,54,1962,684,22.3,1810.7
4454238812,0,13,3,0,7,7,8,0,0,0,0,16164,6.8,18803,239,40,-1050,88,23.9,1616.4,14,2,1,7,7,8,1,1,0,0,17214,7.2,18715,237,47,1050,-88,23.7,1721.4
4527045294,0,16,4,0,6,11,8,0,0,0,0,16536,6.8,16917,232,41,-2018,-2401,23.2,1653.6,76,4,1,11,6,12,1,1,0,0,18554,7.0,19318,232,48,2018,2401,23.2,1855.4
4492897739,0,14,1,1,7,9,9,0,0,0,0,15888,6.6,15944,195,36,-1696,-2535,19.5,1588.8,11,3,0,9,7,7,0,0,0,0,17584,7.2,18479,186,52,1696,2535,18.6,1758.4
4489563821,0,14,0,1,3,6,3,2,1,1,0,15900,6.8,17700,234,40,-1286,-995,23.4,1590.0,14,1,0,6,3,6,0,0,0,0,17186,7.0,18695,214,54,1286,995,21.4,1718.6
4506831821,0,15,2,1,2,12,3,0,0,0,0,14379,6.6,16423,203,49,-6676,-3924,20.3,1437.9,12,5,0,12,2,14,1,1,0,1,21055,7.2,20347,223,66,6676,3924,22.3,2105.5
4498029734,0,15,3,0,7,6,7,0,0,0,0,17055,7.2,19405,230,55,567,1254,23.0,1705.5,19,2,1,6,7,7,1,1,0,0,16488,7.0,18151,201,60,-567,-1254,20.1,1648.8
4502376872,0,18,1,0,5,9,6,0,0,0,0,14988,6.6,16513,200,40,-2824,-2021,20.0,1498.8,16,4,1,9,5,10,0,0,0,0,17812,6.8,18534,222,56,2824,2021,22.2,1781.2
4471229287,0,20,3,0,3,8,5,0,0,0,0,13980,6.2,15030,193,44,-3739,-3541,19.3,1398.0,39,1,1,8,3,9,2,1,1,0,17719,7.2,18571,246,48,3739,3541,24.6,1771.9
4520639515,0,15,7,0,7,10,5,1,0,1,0,17119,6.8,18614,216,44,-977,271,21.6,1711.9,18,3,1,10,7,12,1,1,0,0,18096,7.0,18343,215,55,977,-271,21.5,1809.6
4527015583,0,14,1,0,6,11,4,0,0,0,0,15775,6.8,17025,206,44,-2861,-1651,20.6,1577.5,17,1,1,11,6,14,1,1,0,0,18636,7.0,18676,210,52,2861,1651,21.0,1863.6
4475361791,0,18,4,1,4,5,5,1,0,1,0,15481,6.6,17390,222,40,481,977,22.2,1548.1,19,3,0,5,4,8,1,1,0,0,15000,6.4,16413,199,51,-481,-977,19.9,1500.0
4509576274,0,14,1,1,10,5,9,1,1,0,0,18611,7.6,20169,225,68,2819,3222,22.5,1861.1,17,2,0,5,10,6,0,0,0,0,15792,6.8,16947,211,49,-2819,-3222,21.1,1579.2
4521525873,0,13,1,1,6,8,4,0,0,0,0,16112,6.8,17371,197,50,-554,-483,19.7,1611.2,17,3,0,8,6,10,1,1,0,0,16666,7.0,17854,206,41,554,483,20.6,1666.6
4524714078,0,11,1,0,3,6,3,2,1,1,0,15685,7.0,18609,232,58,-516,266,23.2,1568.5,14,1,1,6,3,8,0,0,0,0,16201,6.8,18343,208,45,516,-266,20.8,1620.1
4495729689,0,16,3,0,5,8,3,0,0,0,0,15967,6.4,16964,223,44,-1578,-598,22.3,1596.7,276,1,1,8,5,10,2,1,1,0,17545,7.0,17562,206,40,1578,598,20.6,1754.5
4488677856,0,12,3,0,9,10,10,1,0,1,2,18947,6.8,17963,215,36,412,-655,21.5,1894.7,18,3,1,10,9,13,1,1,0,0,18535,7.2,18618,241,50,-412,655,24.1,1853.5
4484202085,0,41,3,1,9,9,13,1,1,0,0,17641,6.8,16803,199,38,436,338,19.9,1764.1,18,5,0,9,9,11,0,0,0,0,17205,6.4,16465,207,33,-436,-338,20.7,1720.5
4517523977,0,13,0,0,8,10,5,1,0,1,0,16781,6.8,17736,180,42,-1611,-1624,18.0,1678.1,13,3,1,10,8,13,1,1,0,0,18392,7.4,19360,188,53,1611,1624,18.8,1839.2
4498101728,0,13,1,0,5,12,5,1,1,0,0,15224,6.6,16423,203,45,-4927,-5216,20.3,1522.4,40,2,1,12,5,11,0,0,0,0,20151,7.8,21639,231,63,4927,5216,23.1,2015.1
4518317987,0,18,5,0,6,5,4,0,0,0,0,15959,6.8,16675,236,40,66,-115,23.6,1595.9,19,5,1,5,6,5,1,1,0,0,15893,6.6,16790,187,47,-66,115,18.7,1589.3
4514796338,0,16,1,0,2,6,3,0,0,0,0,15509,7.0,18064,235,58,-1098,-966,23.5,1550.9,138,3,1,6,2,4,2,1,1,0,16607,7.2,19030,204,68,1098,966,20.4,1660.7
4526030769,0,14,1,0,5,17,3,0,0,0,0,14494,6.6,15666,181,36,-5290,-3110,18.1,1449.4,12,2,1,17,5,14,1,1,0,0,19784,7.2,18776,192,48,5290,3110,19.2,1978.4
4466130719,0,15,2,0,6,2,9,2,1,1,0,16260,6.8,17559,224,49,1481,528,22.4,1626.0,15,3,1,2,6,5,0,0,0,0,14779,6.6,17031,195,64,-1481,-528,19.5,1477.9
4471999593,0,15,4,0,6,3,3,0,0,0,0,15365,6.4,16848,186,44,-136,-385,18.6,1536.5,19,3,1,3,6,3,0,0,0,0,15501,6.6,17233,219,48,136,385,21.9,1550.1
4481132902,0,13,0,0,6,12,4,0,0,0,0,16048,6.6,16740,209,40,-2954,-2865,20.9,1604.8,15,2,1,12,6,15,0,0,0,0,19002,7.2,19605,206,55,2954,2865,20.6,1900.2
4520956712,0,13,1,0,7,5,8,0,0,0,0,17160,7.0,18450,221,42,2613,1450,22.1,1716.0,13,3,1,5,7,3,1,1,0,0,14547,6.4,17000,213,36,-2613,-1450,21.3,1454.7
4525072812,0,14,2,0,7,7,10,1,1,0,0,16972,7.2,19060,209,48,-1031,-394,20.9,1697.2,16,4,1,7,7,7,0,0,0,0,18003,7.4,19454,255,60,1031,394,25.5,1800.3
4509906383,0,16,1,0,7,11,8,0,0,0,0,15919,6.8,16956,200,32,-2604,-1096,20.0,1591.9,15,1,1,11,7,10,0,0,0,0,18523,7.0,18052,183,48,2604,1096,18.3,1852.3
4515697055,0,13,7,1,7,6,7,0,0,0,0,16443,7.0,18461,193,52,-1706,-1027,19.3,1644.3,16,1,0,6,7,6,0,0,0,0,18149,7.2,19488,247,68,1706,1027,24.7,1814.9
4503341875,0,22,2,1,9,7,10,0,0,0,0,18400,7.2,18909,221,60,2746,1975,22.1,1840.0,39,1,0,7,9,10,1,1,0,0,15654,6.6,16934,164,52,-2746,-1975,16.4,1565.4
4447477693,0,17,3,0,8,8,11,0,0,0,0,16634,7.0,17892,198,40,-355,279,19.8,1663.4,38,3,1,8,8,7,0,0,0,0,16989,6.8,17613,195,44,355,-279,19.5,1698.9
4500102951,0,14,4,1,7,7,7,0,0,0,0,16781,6.8,17415,194,52,-2063,-1448,19.4,1678.1,27,1,0,7,7,7,0,0,0,1,18844,7.0,18863,232,52,2063,1448,23.2,1884.4
4526164537,0,17,2,0,4,8,4,0,0,0,0,14434,6.6,15829,183,40,-4603,-2667,18.3,1443.4,17,4,1,8,4,11,2,1,1,1,19037,7.0,18496,212,48,4603,2667,21.2,1903.7
4519368335,0,18,4,1,3,8,2,0,0,0,0,14711,6.8,16559,222,40,-3156,-3287,22.2,1471.1,18,4,0,8,3,6,0,0,0,0,17867,7.2,19846,238,54,3156,3287,23.8,1786.7
4450504768,0,22,3,0,0,5,0,0,0,0,0,13643,7.0,16820,217,62,-3585,-3405,21.7,1364.3,18,4,1,5,0,6,1,1,0,0,17228,7.4,20225,266,68,3585,3405,26.6,1722.8
4478351147,0,13,3,0,4,11,0,0,0,0,0,14891,6.8,17683,218,59,-4035,-2639,21.8,1489.1,18,3,1,11,4,11,1,1,0,0,18926,7.4,20322,246,51,4035,2639,24.6,1892.6
4527238809,0,14,3,1,5,8,6,0,0,0,0,14557,6.4,15691,169,52,-3666,-2993,16.9,1455.7,17,2,0,8,5,8,0,0,0,0,18223,7.2,18684,235,52,3666,2993,23.5,1822.3
4477778320,0,14,4,1,7,11,5,0,0,0,0,16308,6.8,17166,195,42,-1903,-1398,19.5,1630.8,17,2,0,11,7,10,1,1,0,0,18211,7.2,18564,214,36,1903,1398,21.4,1821.1
4437014946,0,14,2,1,3,2,3,0,0,0,0,15734,7.0,18750,236,68,465,-911,23.6,1573.4,82,3,0,2,3,1,1,1,0,0,15269,7.2,19661,226,76,-465,911,22.6,1526.9
4522167652,0,18,0,0,3,6,4,0,0,0,0,14364,6.8,16898,204,48,-2845,-1461,20.4,1436.4,18,2,1,6,3,5,1,1,0,0,17209,7.0,18359,208,55,2845,1461,20.8,1720.9
4519295854,0,11,1,0,8,8,6,1,1,0,0,16002,6.8,17397,177,52,-1260,-1183,17.7,1600.2,11,2,1,8,8,13,0,0,0,0,17262,7.0,18580,209,56,1260,1183,20.9,1726.2
4523089267,0,16,2,1,10,11,9,0,0,0,0,19029,7.4,19459,234,49,340,1086,23.4,1902.9,11,3,0,11,10,14,0,0,0,0,18689,7.2,18373,182,40,-340,-1086,18.2,1868.9
4500946527,0,17,3,0,2,8,4,0,0,0,0,14845,6.4,16713,236,49,-3193,-2101,23.6,1484.5,120,3,1,8,2,14,1,1,0,0,18038,7.2,18814,207,61,3193,2101,20.7,1803.8
4522851544,0,15,2,0,4,8,5,0,0,0,0,14993,6.6,16251,215,33,-1845,-1879,21.5,1499.3,14,6,1,8,4,10,1,1,0,0,16838,7.0,18130,229,52,1845,1879,22.9,1683.8
4458069984,0,23,3,1,3,6,3,1,0,1,1,16970,6.8,17789,252,64,381,108,25.2,1697.0,11,3,0,6,3,9,1,1,0,0,16589,7.0,17681,199,62,-381,-108,19.9,1658.9
4523351869,0,36,5,1,3,2,3,1,1,0,0,15951,7.0,19210,247,70,1151,1753,24.7,1595.1,48,4,0,2,3,1,1,0,1,0,14800,6.8,17457,236,45,-1151,-1753,23.6,1480.0
4524674585,0,33,1,0,5,13,2,0,0,0,0,16145,7.0,17749,221,40,-2746,-1939,22.1,1614.5,13,1,1,13,5,14,1,1,0,0,18891,7.2,19688,229,58,2746,1939,22.9,1889.1
4484792751,0,157,2,1,6,8,4,2,1,1,0,16385,6.6,17327,215,58,-219,-589,21.5,1638.5,14,1,0,8,6,15,0,0,0,0,16604,6.8,17916,199,48,219,589,19.9,1660.4
4470854318,0,56,1,0,6,10,8,1,0,1,0,15633,6.8,17605,210,36,-2770,-2347,21.0,1563.3,14,2,1,10,6,13,1,1,0,0,18403,7.2,19952,218,52,2770,2347,21.8,1840.3
4508715619,0,17,3,1,5,4,3,0,0,0,0,16199,7.0,18624,205,65,512,858,20.5,1619.9,14,6,0,4,5,4,0,0,0,0,15687,6.8,17766,218,61,-512,-858,21.8,1568.7
4524577264,0,16,5,0,4,5,7,0,0,0,0,15820,7.0,18001,242,58,-758,-392,24.2,1582.0,16,3,1,5,4,4,2,1,1,0,16578,7.2,18393,229,52,758,392,22.9,1657.8
4522664876,0,16,3,1,7,5,7,0,0,0,0,17406,7.0,18922,240,48,1104,183,24.0,1740.6,15,4,0,5,7,8,1,1,0,0,16302,7.2,18739,207,48,-1104,-183,20.7,1630.2
4494648390,0,15,3,1,6,8,8,0,0,0,0,15697,6.8,16449,196,44,-1237,-285,19.6,1569.7,14,2,0,8,6,13,0,0,0,0,16934,6.4,16734,201,47,1237,285,20.1,1693.4
4519376490,0,14,0,1,7,8,7,1,0,1,0,17140,7.2,18192,207,52,-389,226,20.7,1714.0,15,2,0,8,7,9,1,1,0,0,17529,7.0,17966,208,48,389,-226,20.8,1752.9
4520757711,0,10,3,0,4,7,1,0,0,0,0,15038,6.8,17152,230,52,-1535,-716,23.0,1503.8,16,1,1,7,4,8,1,1,0,0,16573,6.8,17868,215,60,1535,716,21.5,1657.3
4490472819,0,15,2,1,8,8,5,0,0,0,0,16795,6.8,18159,235,48,-507,-790,23.5,1679.5,17,2,0,8,8,9,1,0,1,0,17302,7.2,18949,203,56,507,790,20.3,1730.2
4520983823,0,18,5,0,3,8,3,0,0,0,0,14790,6.4,16619,217,37,-1967,-1292,21.7,1479.0,19,2,1,8,3,11,1,1,0,0,16757,7.0,17911,204,52,1967,1292,20.4,1675.7
4450770211,0,17,7,0,8,9,13,1,1,0,0,17579,7.2,18266,224,41,475,1006,22.4,1757.9,22,2,1,9,8,10,0,0,0,0,17104,6.8,17260,205,36,-475,-1006,20.5,1710.4
4520985137,0,18,3,0,1,7,1,0,0,0,0,13874,6.4,15799,219,33,-2933,-2159,21.9,1387.4,13,2,1,7,1,8,2,1,1,0,16807,7.0,17958,215,62,2933,2159,21.5,1680.7
4505058404,0,14,3,0,2,5,1,0,0,0,0,14815,7.0,17728,226,59,-2116,-2156,22.6,1481.5,16,5,1,5,2,6,1,0,1,0,16931,7.2,19884,237,80,2116,2156,23.7,1693.1
4521772648,0,13,2,1,6,4,7,0,0,0,0,16517,7.0,18263,216,57,954,570,21.6,1651.7,16,3,0,4,6,5,1,1,0,0,15563,6.6,17693,216,44,-954,-570,21.6,1556.3
4492351873,0,15,0,1,10,10,8,0,0,0,1,18544,6.4,17072,182,60,1060,7,18.2,1854.4,39,2,0,10,10,11,1,1,0,0,17484,6.8,17065,174,36,-1060,-7,17.4,1748.4
4505924248,0,15,3,0,2,5,3,0,0,0,0,14993,6.6,17018,241,44,-1481,-1877,24.1,1499.3,17,3,1,5,2,5,1,1,0,0,16474,7.2,18895,226,61,1481,1877,22.6,1647.4
4488507163,0,17,2,0,7,11,13,1,1,0,0,16225,6.6,17213,206,56,-2463,-2163,20.6,1622.5,17,3,1,11,7,13,0,0,0,0,18688,7.4,19376,224,36,2463,2163,22.4,1868.8
4520050863,0,11,5,0,7,15,5,0,0,0,0,15463,6.4,16063,208,20,-3882,-2253,20.8,1546.3,15,1,1,15,7,15,2,1,1,0,19345,7.0,18316,213,40,3882,2253,21.3,1934.5
4505244721,0,11,2,0,5,7,6,0,0,0,0,16456,6.6,17035,213,51,355,-798,21.3,1645.6,19,1,1,7,5,5,2,1,1,0,16101,6.8,17833,223,60,-355,798,22.3,1610.1
4475515736,0,14,2,0,4,7,5,0,0,0,0,14488,6.4,16390,197,36,-3152,-2754,19.7,1448.8,37,0,1,7,4,7,1,1,0,0,17640,7.2,19144,196,84,3152,2754,19.6,1764.0
4502375792,0,13,1,0,6,14,5,1,0,1,1,16749,6.2,15390,203,23,-3586,-2840,20.3,1674.9,67,2,1,14,6,25,1,1,0,1,20335,7.2,18230,194,39,3586,2840,19.4,2033.5
4446037103,0,21,4,1,5,6,3,0,0,0,0,16507,7.2,18410,228,58,731,44,22.8,1650.7,20,4,0,6,5,8,1,0,1,0,15776,7.2,18366,203,47,-731,-44,20.3,1577.6
4519124601,0,17,3,1,4,4,3,1,1,0,0,15842,7.0,18640,240,60,71,409,24.0,1584.2,17,5,0,4,4,6,0,0,0,0,15771,7.0,18231,227,48,-71,-409,22.7,1577.1
4522461341,0,15,13,0,3,9,1,1,1,0,0,14711,6.8,18284,204,52,-3559,-1400,20.4,1471.1,42,3,1,9,3,7,0,0,0,0,18270,7.2,19684,256,43,3559,1400,25.6,1827.0
4477027360,0,16,4,0,4,6,3,0,0,0,0,15008,6.6,16888,214,38,-1015,-1751,21.4,1500.8,31,3,1,6,4,4,1,1,0,0,16023,6.8,18639,208,59,1015,1751,20.8,1602.3
4470382093,0,16,4,1,6,8,5,0,0,0,0,16625,7.2,18202,226,48,-810,-730,22.6,1662.5,17,4,0,8,6,9,0,0,0,0,17435,7.4,18932,234,48,810,730,23.4,1743.5
4514370002,0,13,1,0,3,4,5,0,0,0,0,14751,6.8,17562,217,39,-982,36,21.7,1475.1,13,1,1,4,3,6,1,1,0,0,15733,6.8,17526,210,72,982,-36,21.0,1573.3
4515568453,0,15,1,0,8,10,6,0,0,0,0,15995,6.8,17109,172,57,-3535,-1199,17.2,1599.5,11,0,1,10,8,13,1,1,0,1,19530,7.2,18308,220,44,3535,1199,22.0,1953.0
4523487666,0,9,2,1,6,5,6,1,0,1,0,16782,7.0,19622,238,61,817,350,23.8,1678.2,17,1,0,5,6,5,1,1,0,0,15965,7.2,19272,235,51,-817,-350,23.5,1596.5
4491135325,0,20,0,0,8,12,11,0,0,0,0,17540,7.0,17368,182,54,-3563,-1320,18.2,1754.0,16,1,1,12,8,22,1,1,0,0,21103,7.2,18688,198,74,3563,1320,19.8,2110.3
4524898178,0,11,2,0,4,10,4,0,0,0,0,15028,6.8,17417,207,52,-3472,-2256,20.7,1502.8,19,1,1,10,4,5,1,1,0,0,18500,7.4,19673,230,52,3472,2256,23.0,1850.0
4517633575,0,12,6,0,1,6,0,0,0,0,0,14625,6.8,17769,241,56,-1299,-49,24.1,1462.5,53,1,1,6,1,3,1,1,0,0,15924,7.0,17818,218,47,1299,49,21.8,1592.4
4520785581,0,12,2,0,7,8,7,0,0,0,0,16304,6.8,17825,201,51,-28,-63,20.1,1630.4,14,1,1,8,7,4,0,0,0,0,16332,6.8,17888,209,41,28,63,20.9,1633.2
4494913568,0,16,3,1,7,11,11,0,0,0,0,17037,7.0,18710,243,47,-1896,-1756,24.3,1703.7,15,2,0,11,7,13,1,1,0,0,18933,7.4,20466,243,50,1896,1756,24.3,1893.3
4511479972,0,15,6,0,8,8,9,0,0,0,0,16345,7.0,17692,206,43,-1208,-213,20.6,1634.5,18,5,1,8,8,9,2,1,1,0,17553,7.0,17905,223,56,1208,213,22.3,1755.3
4518094361,0,15,1,0,6,10,7,0,0,0,0,14978,6.6,16243,147,40,-4413,-1993,14.7,1497.8,20,4,1,10,6,16,2,1,1,1,19391,7.0,18236,237,55,4413,1993,23.7,1939.1
4492216281,0,20,0,0,6,10,4,0,0,0,0,14626,6.4,16067,154,43,-4726,-2067,15.4,1462.6,11,3,1,10,6,11,1,1,0,1,19352,7.0,18134,224,52,4726,2067,22.4,1935.2
4429821639,0,11,2,1,11,2,9,2,1,1,0,17435,7.0,19432,236,52,1220,589,23.6,1743.5,14,2,0,2,11,2,0,0,0,0,16215,7.0,18843,241,68,-1220,-589,24.1,1621.5
4467610572,0,15,4,1,5,4,6,1,0,1,0,16457,7.0,18669,229,60,1023,1754,22.9,1645.7,19,2,0,4,5,7,0,0,0,0,15434,6.6,16915,219,53,-1023,-1754,21.9,1543.4
4447981243,0,18,3,1,2,13,2,1,1,0,0,14368,6.8,16711,201,52,-5683,-5256,20.1,1436.8,19,5,0,13,2,13,0,0,0,0,20051,8.0,21967,270,49,5683,5256,27.0,2005.1
4513054985,0,13,2,1,5,7,6,0,0,0,0,15747,6.8,17503,192,41,-1123,-1230,19.2,1574.7,14,2,0,7,5,6,1,1,0,0,16870,7.0,18733,227,59,1123,1230,22.7,1687.0
4437780946,0,17,5,0,6,6,2,0,0,0,0,15196,6.8,18612,209,52,-1240,-76,20.9,1519.6,13,2,1,6,6,6,1,1,0,0,16436,7.0,18688,210,68,1240,76,21.0,1643.6
4519903713,0,33,2,0,4,11,5,1,1,0,0,15788,6.6,17331,223,52,-3084,-3141,22.3,1578.8,11,0,1,11,4,9,0,0,0,0,18872,7.6,20472,230,64,3084,3141,23.0,1887.2
4523558547,0,17,3,1,9,6,7,0,0,0,0,17187,7.0,18178,213,40,626,98,21.3,1718.7,14,1,0,6,9,4,0,0,0,0,16561,7.0,18080,231,40,-626,-98,23.1,1656.1
4527127873,0,20,1,0,1,8,1,0,0,0,0,13006,6.0,14750,201,44,-6892,-5371,20.1,1300.6,18,1,1,8,1,12,2,1,1,1,19898,7.2,20121,233,76,6892,5371,23.3,1989.8
4516722172,0,15,2,1,7,3,7,2,1,1,0,16467,6.8,17952,209,48,1418,129,20.9,1646.7,31,1,0,3,7,2,0,0,0,0,15049,6.8,17823,231,56,-1418,-129,23.1,1504.9
4464565821,0,20,5,0,4,9,3,1,1,0,0,15211,6.8,17951,225,56,-3848,-2091,22.5,1521.1,16,2,1,9,4,14,1,0,1,0,19059,7.2,20042,238,68,3848,2091,23.8,1905.9
4519724135,0,14,0,1,8,10,11,0,0,0,0,16052,6.4,15330,159,44,-1825,-1458,15.9,1605.2,18,1,0,10,8,14,1,1,0,0,17877,6.6,16788,213,41,1825,1458,21.3,1787.7
4525163715,0,36,6,0,2,12,2,0,0,0,0,13802,6.8,17008,202,52,-5571,-2139,20.2,1380.2,18,20,1,12,2,16,2,1,1,0,19373,7.2,19147,247,48,5571,2139,24.7,1937.3
4488755815,0,14,5,1,9,8,11,1,1,0,0,16940,7.0,18041,191,40,-896,-393,19.1,1694.0,19,3,0,8,9,8,0,0,0,0,17836,7.0,18434,235,45,896,393,23.5,1783.6
4473146660,0,13,9,0,3,9,5,0,0,0,0,14724,6.4,16015,218,42,-3541,-2434,21.8,1472.4,43,2,1,9,3,13,1,1,0,0,18265,6.8,18449,244,56,3541,2434,24.4,1826.5
4509532137,0,21,4,1,5,14,3,0,0,0,0,15425,6.6,16296,204,31,-2904,-3121,20.4,1542.5,18,4,0,14,5,10,0,0,0,0,18329,7.2,19417,212,48,2904,3121,21.2,1832.9
4493402938,0,11,4,1,7,10,5,0,0,0,0,16112,7.0,18155,202,42,-2967,-758,20.2,1611.2,15,1,0,10,7,10,0,0,0,0,19079,7.2,18913,238,45,2967,758,23.8,1907.9
4519161912,0,17,1,0,6,11,9,0,0,0,0,15536,6.4,15213,179,31,-4562,-3519,17.9,1553.6,20,5,1,11,6,14,2,1,1,1,20098,7.2,18732,226,51,4562,3519,22.6,2009.8
4516946022,0,26,0,0,14,8,12,1,1,0,0,19094,7.2,19076,196,56,1693,1287,19.6,1909.4,16,3,1,8,14,6,0,0,0,0,17401,6.8,17789,214,43,-1693,-1287,21.4,1740.1
4524259924,0,18,4,1,7,7,9,1,0,1,0,16517,6.6,16968,182,50,473,446,18.2,1651.7,18,2,0,7,7,7,1,1,0,0,16044,6.6,16522,183,42,-473,-446,18.3,1604.4
4478629184,0,28,4,0,3,4,3,1,1,0,0,14383,6.4,15898,211,55,-890,-528,21.1,1438.3,16,2,1,4,3,5,1,0,1,0,15273,6.4,16426,208,44,890,528,20.8,1527.3
4521266172,0,15,2,1,5,2,8,1,1,0,0,16348,7.0,18350,243,47,1476,1149,24.3,1634.8,19,2,0,2,5,4,0,0,0,0,14872,6.8,17201,233,51,-1476,-1149,23.3,1487.2
4479522740,0,14,4,1,5,7,6,0,0,0,0,15742,6.8,17327,228,36,-1964,-3104,22.8,1574.2,19,2,0,7,5,6,1,1,0,0,17706,7.6,20431,241,76,1964,3104,24.1,1770.6
4465543181,0,17,4,0,1,10,1,0,0,0,0,14453,6.8,17152,244,52,-2889,-2882,24.4,1445.3,21,2,1,10,1,6,1,1,0,0,17342,7.2,20034,216,55,2889,2882,21.6,1734.2
4522477887,0,21,2,1,11,11,13,0,0,0,0,18878,6.8,18276,222,48,1212,-257,22.2,1887.8,18,2,0,11,11,8,0,0,0,0,17666,7.0,18533,212,40,-1212,257,21.2,1766.6
4483466671,0,22,2,0,7,6,10,0,0,0,1,18376,7.0,17877,225,48,2595,776,22.5,1837.6,33,4,1,6,7,4,2,1,1,0,15781,6.6,17101,201,59,-2595,-776,20.1,1578.1
4465280441,0,76,2,0,10,9,13,0,0,0,0,18695,7.2,18459,225,48,601,152,22.5,1869.5,47,2,1,9,10,9,0,0,0,0,18094,7.0,18307,199,52,-601,-152,19.9,1809.4
4484501357,0,17,3,0,1,5,3,0,0,0,0,14463,6.8,18394,224,68,-2820,-1048,22.4,1446.3,18,2,1,5,1,8,1,1,0,0,17283,7.4,19442,258,68,2820,1048,25.8,1728.3
4526189371,0,13,0,0,6,9,4,0,0,0,0,15917,6.8,17466,200,51,-3142,-2289,20.0,1591.7,13,2,1,9,6,8,0,0,0,0,19059,7.4,19755,243,56,3142,2289,24.3,1905.9
4489090931,0,15,3,1,5,6,7,0,0,0,0,15684,6.8,17384,170,56,-1434,-1409,17.0,1568.4,17,4,0,6,5,3,1,0,1,0,17118,7.2,18793,223,52,1434,1409,22.3,1711.8
4521010137,0,16,4,1,8,5,7,0,0,0,0,17044,6.8,17686,217,46,845,-234,21.7,1704.4,14,1,0,5,8,5,1,1,0,0,16199,6.8,17920,207,60,-845,234,20.7,1619.9
4523105100,0,12,5,1,2,6,1,0,0,0,0,14417,6.6,16652,198,60,-1930,-2043,19.8,1441.7,17,2,0,6,2,7,1,1,0,0,16347,7.2,18695,223,53,1930,2043,22.3,1634.7
4520518919,0,18,1,0,5,4,5,0,0,0,0,15984,7.2,17527,203,54,193,89,20.3,1598.4,15,3,1,4,5,4,0,0,0,0,15791,6.8,17438,222,50,-193,-89,22.2,1579.1
4518869333,0,14,1,0,7,8,4,1,1,0,0,17209,6.8,17808,229,37,1710,1298,22.9,1720.9,14,0,1,8,7,5,0,0,0,0,15499,6.4,16510,166,46,-1710,-1298,16.6,1549.9
4523623443,0,13,6,0,6,13,6,0,0,0,0,16420,6.6,16281,223,40,-3593,-3086,22.3,1642.0,21,2,1,13,6,12,2,1,1,0,20013,7.4,19367,229,60,3593,3086,22.9,2001.3
4499276253,0,13,2,0,1,2,2,0,0,0,0,12884,6.4,15586,174,40,-2825,-3105,17.4,1288.4,16,2,1,2,1,4,1,1,0,0,15709,7.0,18691,239,63,2825,3105,23.9,1570.9
4456973095,0,16,0,0,0,4,0,1,0,1,0,14175,6.6,17400,234,60,-1769,-2076,23.4,1417.5,15,4,1,4,0,6,1,1,0,0,15944,7.4,19476,249,56,1769,2076,24.9,1594.4
4453066386,0,16,2,0,2,8,2,1,0,1,0,14786,6.6,16676,233,50,-1340,-529,23.3,1478.6,16,4,1,8,2,6,1,1,0,0,16126,6.8,17205,205,37,1340,529,20.5,1612.6
4526486021,0,14,5,0,8,9,11,0,0,0,0,17149,7.0,18495,218,39,-1258,-725,21.8,1714.9,36,1,1,9,8,8,1,1,0,0,18407,7.4,19220,214,68,1258,725,21.4,1840.7
4438188395,0,19,3,0,9,8,8,0,0,0,0,16823,6.8,17411,219,33,-1071,-1667,21.9,1682.3,18,2,1,8,9,10,1,1,0,0,17894,7.2,19078,210,63,1071,1667,21.0,1789.4
4515907973,0,14,4,1,6,9,6,0,0,0,0,15946,7.0,17404,222,32,-1565,-467,22.2,1594.6,17,0,0,9,6,15,0,0,0,0,17511,6.8,17871,187,40,1565,467,18.7,1751.1
4472652986,0,17,4,0,7,8,6,1,1,0,0,16007,7.0,17830,204,47,-873,308,20.4,1600.7,17,3,1,8,7,7,0,0,0,0,16880,6.8,17522,215,44,873,-308,21.5,1688.0
4501029186,0,18,3,0,6,10,10,0,0,0,0,16876,6.6,16812,238,40,-1015,-1031,23.8,1687.6,15,6,1,10,6,9,0,0,0,0,17891,6.8,17843,212,48,1015,1031,21.2,1789.1
4524894613,0,18,2,1,8,2,8,1,0,1,0,17847,7.0,18916,207,60,3060,1838,20.7,1784.7,15,2,0,2,8,3,0,0,0,0,14787,6.6,17078,221,60,-3060,-1838,22.1,1478.7
4522021441,0,12,2,0,1,10,0,0,0,0,0,13410,6.4,16059,210,52,-5025,-2610,21.0,1341.0,19,4,1,10,1,16,1,1,0,0,18435,7.2,18669,228,58,5025,2610,22.8,1843.5
4513528910,0,20,5,0,5,4,4,0,0,0,0,15960,7.2,18478,232,64,782,1903,23.2,1596.0,16,4,1,4,5,5,1,1,0,0,15178,6.4,16575,211,43,-782,-1903,21.1,1517.8
4526573339,0,55,2,1,8,6,7,1,1,0,0,17403,7.4,19112,215,47,1518,1874,21.5,1740.3,17,1,0,6,8,9,0,0,0,0,15885,6.6,17238,192,40,-1518,-1874,19.2,1588.5
4494104479,0,77,3,0,6,11,4,0,0,0,0,15838,7.0,18031,204,52,-2468,-1853,20.4,1583.8,86,5,1,11,6,9,1,1,0,0,18306,7.4,19884,219,80,2468,1853,21.9,1830.6
4477496962,0,15,2,0,7,7,14,0,0,0,0,16750,6.6,17492,214,44,-2128,-1873,21.4,1675.0,18,4,1,7,7,3,2,1,1,1,18878,7.2,19365,236,72,2128,1873,23.6,1887.8
4520567149,0,20,3,1,9,8,11,1,1,0,0,17429,6.8,17309,211,48,720,-183,21.1,1742.9,16,4,0,8,9,10,0,0,0,0,16709,6.8,17492,210,50,-720,183,21.0,1670.9
4512906607,0,16,2,1,7,2,8,0,0,0,0,17381,7.2,18931,258,42,2389,892,25.8,1738.1,18,2,0,2,7,2,1,1,0,0,14992,7.0,18039,216,56,-2389,-892,21.6,1499.2
4512993311,0,16,1,0,4,12,3,0,0,0,0,15335,6.4,16838,187,71,-3983,-3676,18.7,1533.5,39,1,1,12,4,9,0,0,0,0,19318,7.4,20514,242,45,3983,3676,24.2,1931.8
4520794525,0,44,4,0,6,8,7,0,0,0,0,16295,6.8,17588,222,47,-1271,-364,22.2,1629.5,11,4,1,8,6,10,1,1,0,0,17566,6.8,17952,219,47,1271,364,21.9,1756.6
4481806461,0,23,1,0,6,14,7,1,1,0,0,15880,6.6,16941,204,45,-4526,-2062,20.4,1588.0,18,2,1,14,6,23,0,0,0,0,20406,7.0,19003,201,49,4526,2062,20.1,2040.6
4523478644,0,30,5,0,6,8,6,0,0,0,0,15567,6.6,16972,167,47,-1737,-776,16.7,1556.7,25,2,1,8,6,6,1,1,0,0,17304,7.0,17748,245,52,1737,776,24.5,1730.4
4474642048,0,17,4,1,16,5,21,1,1,0,0,19234,7.0,18339,193,32,2899,1508,19.3,1923.4,16,4,0,5,16,7,0,0,0,0,16335,6.8,16831,211,61,-2899,-1508,21.1,1633.5
4437489184,0,34,2,0,10,9,9,1,1,0,0,18329,7.0,18315,219,53,947,-188,21.9,1832.9,47,3,1,9,10,11,0,0,0,0,17382,7.2,18503,194,48,-947,188,19.4,1738.2
4525141412,0,13,1,0,9,7,10,0,0,0,0,16017,6.8,17022,182,34,-58,13,18.2,1601.7,14,2,1,7,9,3,1,1,0,0,16075,6.8,17009,228,37,58,-13,22.8,1607.5
4512258772,0,18,4,1,8,1,6,1,0,1,0,18607,7.4,20228,264,53,4488,3191,26.4,1860.7,15,1,0,1,8,1,1,1,0,0,14119,6.6,17037,210,60,-4488,-3191,21.0,1411.9
4522642562,0,16,3,1,10,7,5,1,1,0,0,17454,6.8,18029,204,58,617,128,20.4,1745.4,12,1,0,7,10,5,0,0,0,0,16837,6.8,17901,178,60,-617,-128,17.8,1683.7
4524538444,0,16,4,0,6,15,7,0,0,0,0,15484,6.6,16418,165,46,-4879,-3465,16.5,1548.4,44,5,1,15,6,16,1,1,0,0,20363,7.4,19883,250,39,4879,3465,25.0,2036.3
4415032113,0,18,3,0,3,12,6,0,0,0,0,13961,6.2,14440,168,25,-4731,-2817,16.8,1396.1,20,7,1,12,3,21,0,0,0,0,18692,6.8,17257,206,42,4731,2817,20.6,1869.2
4523463399,0,16,3,1,3,9,4,0,0,0,0,14725,6.6,16460,200,38,-2959,-2726,20.0,1472.5,19,3,0,9,3,9,0,0,0,0,17684,7.0,19186,213,48,2959,2726,21.3,1768.4
4478417424,0,15,3,0,6,11,3,0,0,0,0,16225,7.0,17831,203,49,-2741,-425,20.3,1622.5,20,4,1,11,6,16,1,1,0,1,18966,7.0,18256,220,34,2741,425,22.0,1896.6
4477234655,0,17,4,1,2,7,3,0,0,0,0,14269,6.6,16548,196,58,-2153,-1519,19.6,1426.9,16,4,0,7,2,8,0,0,0,0,16422,7.0,18067,211,39,2153,1519,21.1,1642.2
4519318813,0,11,1,1,6,4,6,1,1,0,0,15437,6.6,16652,198,52,-152,-901,19.8,1543.7,17,3,0,4,6,6,1,0,1,0,15589,7.0,17553,220,49,152,901,22.0,1558.9
4510184598,0,26,2,0,2,5,5,0,0,0,0,12886,6.0,14091,165,32,-3117,-3799,16.5,1288.6,13,4,1,5,2,4,1,1,0,0,16003,6.8,17890,206,60,3117,3799,20.6,1600.3
4525852452,0,15,1,0,1,3,1,1,1,0,0,13253,6.4,16475,190,51,-2310,-2290,19.0,1325.3,16,0,1,3,1,1,0,0,0,0,15563,7.4,18765,248,60,2310,2290,24.8,1556.3
4522518201,0,9,5,1,8,1,5,0,0,0,0,17761,7.4,20143,247,48,2501,2298,24.7,1776.1,18,2,0,1,8,1,0,0,0,0,15260,6.6,17845,251,56,-2501,-2298,25.1,1526.0
4525764211,0,11,0,0,2,6,2,0,0,0,0,14756,6.8,17221,217,50,-1942,-407,21.7,1475.6,10,3,1,6,2,6,1,1,0,0,16698,6.6,17628,212,69,1942,407,21.2,1669.8
4476486795,0,68,6,0,4,6,4,0,0,0,0,15528,6.8,17590,230,43,-2446,-1508,23.0,1552.8,15,4,1,6,4,4,1,1,0,1,17974,7.0,19098,248,72,2446,1508,24.8,1797.4
4520786519,0,19,8,0,5,4,5,1,1,0,0,16221,7.0,18135,241,49,1457,1939,24.1,1622.1,22,2,1,4,5,9,0,0,0,0,14764,6.6,16196,205,43,-1457,-1939,20.5,1476.4
4527378192,0,44,5,1,9,8,9,1,1,0,0,17375,7.2,18906,210,46,-522,269,21.0,1737.5,16,0,0,8,9,7,1,0,1,1,17897,7.0,18637,190,46,522,-269,19.0,1789.7
4505627084,0,19,3,1,9,8,12,1,1,0,0,17394,6.6,16652,175,56,182,-159,17.5,1739.4,16,6,0,8,9,7,0,0,0,0,17212,6.4,16811,192,48,-182,159,19.2,1721.2
4522599017,0,13,4,1,6,5,7,0,0,0,0,16053,6.8,18228,216,48,611,381,21.6,1605.3,20,1,0,5,6,5,1,1,0,0,15442,6.8,17847,208,46,-611,-381,20.8,1544.2
4487326778,0,15,3,0,3,11,3,0,0,0,0,14579,6.6,15951,227,35,-3603,-3793,22.7,1457.9,16,3,1,11,3,9,0,0,0,0,18182,7.2,19744,232,49,3603,3793,23.2,1818.2
4458619259,0,16,3,0,3,9,2,0,0,0,0,14861,6.8,16993,225,38,-3337,-1701,22.5,1486.1,30,3,1,9,3,10,0,0,0,0,18198,7.2,18694,223,51,3337,1701,22.3,1819.8
4441924667,0,16,6,1,7,5,6,0,0,0,0,16381,7.0,18126,221,56,134,-1142,22.1,1638.1,14,2,0,5,7,3,2,1,1,0,16247,7.2,19268,231,64,-134,1142,23.1,1624.7
4500869291,0,20,3,0,11,8,9,2,1,1,0,17598,7.2,18935,225,52,1380,1402,22.5,1759.8,15,1,1,8,11,8,0,0,0,0,16218,6.8,17533,192,44,-1380,-1402,19.2,1621.8
4518135056,0,16,5,0,4,11,2,2,1,1,0,14285,6.6,16387,182,52,-4177,-1640,18.2,1428.5,17,4,1,11,4,21,0,0,0,0,18462,7.0,18027,209,45,4177,1640,20.9,1846.2
4524245111,0,16,2,0,6,5,4,1,1,0,0,16398,6.6,17974,236,53,768,505,23.6,1639.8,56,5,1,5,6,5,0,0,0,0,15630,7.0,17469,218,49,-768,-505,21.8,1563.0
4482208801,0,18,0,0,3,5,6,0,0,0,1,16690,6.8,17992,248,48,-1060,-586,24.8,1669.0,43,1,1,5,3,7,2,1,1,1,17750,7.0,18578,214,75,1060,586,21.4,1775.0
4522379320,0,17,3,1,5,4,6,2,1,1,0,16635,7.0,18522,217,51,799,239,21.7,1663.5,61,0,0,4,5,9,0,0,0,0,15836,6.8,18283,240,52,-799,-239,24.0,1583.6
4515778115,0,16,2,0,7,8,12,0,0,0,0,17737,7.0,18616,234,44,648,617,23.4,1773.7,15,4,1,8,7,10,1,1,0,0,17089,7.0,17999,202,51,-648,-617,20.2,1708.9
4521474530,0,15,0,0,7,11,4,1,1,0,0,16113,6.4,16221,186,46,-1172,-1033,18.6,1611.3,15,3,1,11,7,14,0,0,0,0,17285,6.8,17254,203,28,1172,1033,20.3,1728.5
4481832485,0,22,3,0,4,7,6,1,0,1,0,16135,7.0,18177,234,47,-1782,-1311,23.4,1613.5,17,3,1,7,4,8,1,1,0,0,17917,7.2,19488,264,53,1782,1311,26.4,1791.7
4456179027,0,55,0,0,4,3,2,0,0,0,0,15335,6.8,18648,230,40,-188,270,23.0,1533.5,11,3,1,3,4,2,1,1,0,0,15523,7.0,18378,248,60,188,-270,24.8,1552.3
4484877784,0,18,5,0,3,8,2,1,1,0,0,14905,6.8,17974,233,52,-3282,-1647,23.3,1490.5,18,3,1,8,3,12,0,0,0,0,18187,7.4,19621,225,52,3282,1647,22.5,1818.7
4521381994,0,17,2,0,2,7,3,0,0,0,0,13443,6.4,15718,192,40,-3241,-2297,19.2,1344.3,21,1,1,7,2,3,2,1,1,0,16684,6.8,18015,217,60,3241,2297,21.7,1668.4
4499921176,0,9,2,1,5,15,5,0,0,0,0,14689,6.0,14871,168,36,-7206,-6046,16.8,1468.9,16,1,0,15,5,10,1,1,0,0,21895,7.4,20917,279,58,7206,6046,27.9,2189.5
4515832303,0,49,4,0,3,5,4,0,0,0,0,14586,6.6,16499,194,49,-1494,-700,19.4,1458.6,15,2,1,5,3,5,0,0,0,0,16080,6.6,17199,231,45,1494,700,23.1,1608.0
4518472442,0,17,3,0,8,4,8,1,1,0,0,17415,6.8,16774,232,48,2791,1911,23.2,1741.5,40,4,1,4,8,8,0,0,0,0,14624,6.2,14863,205,26,-2791,-1911,20.5,1462.4
4522240488,0,18,5,0,3,3,7,1,1,0,0,14742,6.6,16390,202,57,-1517,-1565,20.2,1474.2,16,4,1,3,3,5,0,0,0,0,16259,7.0,17955,255,49,1517,1565,25.5,1625.9
4484154962,0,18,3,1,8,10,7,0,0,0,0,16180,6.6,16639,185,36,-2807,-2956,18.5,1618.0,16,3,0,10,8,17,0,0,0,0,18987,7.4,19595,236,61,2807,2956,23.6,1898.7
4471792481,0,11,0,0,6,15,8,0,0,0,0,15653,6.4,16813,158,43,-6105,-4065,15.8,1565.3,11,0,1,15,6,13,0,0,0,1,21758,7.8,20878,223,64,6105,4065,22.3,2175.8
4513514053,0,14,3,0,4,6,3,1,1,0,0,14826,6.8,17334,206,59,-2286,-926,20.6,1482.6,15,1,1,6,4,6,0,0,0,0,17112,6.8,18260,232,50,2286,926,23.2,1711.2
4522643294,0,13,13,0,4,9,8,0,0,0,0,15400,6.6,16910,219,34,-2564,-1518,21.9,1540.0,38,1,1,9,4,10,0,0,0,0,17964,6.8,18428,229,56,2564,1518,22.9,1796.4
4513704975,0,12,2,0,3,11,4,0,0,0,0,14738,6.4,17148,197,63,-4199,-3186,19.7,1473.8,16,3,1,11,3,7,1,1,0,0,18937,7.6,20334,241,56,4199,3186,24.1,1893.7
4519715253,0,50,1,1,7,1,5,0,0,0,1,18193,7.0,18289,225,52,4939,2073,22.5,1819.3,193,0,0,1,7,0,0,0,0,0,13254,6.6,16216,175,66,-4939,-2073,17.5,1325.4
4518737622,0,29,5,1,4,3,7,0,0,0,0,15517,6.6,16917,231,35,653,-556,23.1,1551.7,15,2,0,3,4,1,1,1,0,0,14864,6.6,17473,226,48,-653,556,22.6,1486.4
4526496557,0,15,19,0,3,3,2,1,1,0,0,14964,7.0,17928,235,52,-973,-1732,23.5,1496.4,48,3,1,3,3,1,0,0,0,0,15937,7.2,19660,251,76,973,1732,25.1,1593.7
4477478034,0,17,1,0,5,13,5,0,0,0,0,14642,6.2,15033,171,41,-4958,-2388,17.1,1464.2,29,4,1,13,5,14,1,1,0,0,19600,7.0,17421,231,24,4958,2388,23.1,1960.0
4507022630,0,14,1,1,8,4,10,1,0,1,1,18913,7.4,19182,225,60,3240,1787,22.5,1891.3,19,4,0,4,8,6,1,1,0,0,15673,6.8,17395,237,48,-3240,-1787,23.7,1567.3
4451962379,0,82,3,0,2,10,1,0,0,0,0,14675,6.8,17184,207,44,-3911,-2728,20.7,1467.5,15,1,1,10,2,10,2,1,1,0,18586,7.4,19912,254,40,3911,2728,25.4,1858.6
4477133738,0,14,3,0,7,9,5,0,0,0,0,16855,7.2,18568,221,59,-1297,-856,22.1,1685.5,79,1,1,9,7,8,1,1,0,0,18152,7.2,19424,229,51,1297,856,22.9,1815.2
4491740882,0,13,3,0,2,9,2,0,0,0,0,14663,6.4,15958,228,44,-3148,-2856,22.8,1466.3,17,2,1,9,2,13,1,1,0,0,17811,7.2,18814,215,64,3148,2856,21.5,1781.1
4526037415,0,15,2,1,9,7,12,0,0,0,0,17604,6.8,17925,194,49,1538,1118,19.4,1760.4,50,2,0,7,9,7,1,1,0,0,16066,6.8,16807,168,48,-1538,-1118,16.8,1606.6
4472899697,0,13,2,1,5,6,2,0,0,0,0,15470,6.8,17451,211,44,-522,-577,21.1,1547.0,41,2,0,6,5,4,1,1,0,0,15992,7.0,18028,209,52,522,577,20.9,1599.2
4508510246,0,14,2,1,7,7,4,0,0,0,0,16068,6.8,17309,193,42,-466,608,19.3,1606.8,20,2,0,7,7,9,0,0,0,0,16534,6.4,16701,224,29,466,-608,22.4,1653.4
4523428789,0,17,0,0,6,1,8,1,1,0,0,16973,7.0,18787,250,55,2983,1577,25.0,1697.3,13,4,1,1,6,1,1,0,1,0,13990,6.8,17210,199,48,-2983,-1577,19.9,1399.0
4524499414,0,17,2,0,3,3,3,0,0,0,0,14731,7.0,17886,204,52,-1148,708,20.4,1473.1,19,3,1,3,3,4,1,1,0,0,15879,6.8,17178,237,52,1148,-708,23.7,1587.9
4476983984,0,16,2,1,4,8,4,1,1,0,0,15247,6.6,17064,209,56,-2720,-2473,20.9,1524.7,12,3,0,8,4,9,0,0,0,0,17967,7.2,19537,207,64,2720,2473,20.7,1796.7
4524968728,0,17,2,0,5,11,7,0,0,0,0,15881,6.8,17927,214,39,-1943,-1582,21.4,1588.1,60,3,1,11,5,7,1,1,0,0,17824,7.2,19509,216,45,1943,1582,21.6,1782.4
4494819577,0,44,3,0,4,7,4,1,0,1,0,15475,6.6,16428,195,56,-1972,-1010,19.5,1547.5,16,2,1,7,4,15,0,0,0,0,17447,6.8,17438,230,43,1972,1010,23.0,1744.7
4526878026,0,19,3,1,5,8,2,0,0,0,0,15429,6.6,16825,227,48,-1480,-1366,22.7,1542.9,53,1,0,8,5,10,0,0,0,0,16909,6.8,18191,218,42,1480,1366,21.8,1690.9
4524343705,0,16,0,1,8,10,11,0,0,0,0,17524,6.8,16577,209,41,-293,-1855,20.9,1752.4,16,2,0,10,8,11,1,1,0,0,17817,7.2,18432,211,57,293,1855,21.1,1781.7
4516532233,0,17,0,0,2,13,1,0,0,0,0,14504,6.6,16668,203,58,-3966,-3112,20.3,1450.4,16,4,1,13,2,14,1,1,0,0,18470,7.4,19780,192,53,3966,3112,19.2,1847.0
4465357470,0,19,2,0,5,6,3,0,0,0,0,15722,6.8,17153,224,40,-488,-98,22.4,1572.2,16,3,1,6,5,7,1,1,0,0,16210,6.8,17251,192,48,488,98,19.2,1621.0
4454214561,0,11,1,1,7,9,6,0,0,0,0,16248,7.0,18067,171,63,-2242,-1819,17.1,1624.8,33,2,0,9,7,12,1,1,0,0,18490,7.2,19886,229,45,2242,1819,22.9,1849.0
4511505654,0,105,3,0,5,11,4,0,0,0,0,15617,6.6,17334,202,63,-3516,-2677,20.2,1561.7,11,3,1,11,5,6,1,0,1,0,19133,7.4,20011,237,52,3516,2677,23.7,1913.3
4470582176,0,33,4,1,8,9,9,0,0,0,0,18026,7.0,17839,198,44,726,-455,19.8,1802.6,17,2,0,9,8,12,0,0,0,0,17300,7.0,18294,186,68,-726,455,18.6,1730.0
4524178545,0,19,2,0,2,6,4,1,1,0,0,15175,6.8,17282,214,52,-1409,-16,21.4,1517.5,18,2,1,6,2,5,0,0,0,0,16584,6.8,17298,234,50,1409,16,23.4,1658.4
4514234813,0,52,2,0,6,12,7,0,0,0,0,15456,6.6,16280,188,42,-4920,-3280,18.8,1545.6,15,1,1,12,6,11,1,0,1,1,20376,7.4,19560,240,62,4920,3280,24.0,2037.6
4524880851,0,17,0,0,5,2,6,1,0,1,0,15894,6.8,18026,222,61,409,1405,22.2,1589.4,18,3,1,2,5,3,1,1,0,0,15485,6.8,16621,241,56,-409,-1405,24.1,1548.5
4518193450,0,16,3,0,6,10,8,0,0,0,0,16837,7.2,17911,191,59,-2152,-2041,19.1,1683.7,16,4,1,10,6,8,2,1,1,0,18989,7.4,19952,237,56,2152,2041,23.7,1898.9
4525935490,0,30,4,1,6,13,6,1,1,0,0,16540,7.0,18158,235,66,-2145,-917,23.5,1654.0,14,3,0,13,6,15,1,0,1,0,18685,7.2,19075,193,48,2145,917,19.3,1868.5
4513670045,0,16,3,0,4,4,6,0,0,0,0,15641,7.2,17857,244,40,-1136,-1235,24.4,1564.1,61,2,1,4,4,3,1,1,0,0,16777,7.2,19092,234,71,1136,1235,23.4,1677.7
4470307479,0,18,2,1,5,4,4,0,0,0,0,15843,6.6,16776,220,42,792,-622,22.0,1584.3,16,3,0,4,5,4,0,0,0,0,15051,6.8,17398,185,49,-792,622,18.5,1505.1
4506294418,0,17,1,0,2,2,1,0,0,0,0,15831,7.4,19463,271,64,1134,1160,27.1,1583.1,12,3,1,2,2,0,1,1,0,0,14697,7.0,18303,238,61,-1134,-1160,23.8,1469.7
4460122479,0,21,3,1,10,6,8,1,1,0,0,18280,7.4,19939,241,48,2171,1839,24.1,1828.0,37,5,0,6,10,4,0,0,0,0,16109,7.0,18100,196,48,-2171,-1839,19.6,1610.9
4511365418,0,17,3,1,8,7,10,2,1,1,0,17429,7.0,17332,209,51,900,-802,20.9,1742.9,21,4,0,7,8,6,0,0,0,0,16529,7.0,18134,217,36,-900,802,21.7,1652.9
4507608618,0,34,0,0,6,10,9,0,0,0,0,15569,6.8,17357,167,48,-4346,-2178,16.7,1556.9,12,0,1,10,6,11,1,1,0,0,19915,7.4,19535,239,72,4346,2178,23.9,1991.5
4522384678,0,14,0,1,8,12,3,0,0,0,0,16729,6.4,16290,198,44,-1829,-1132,19.8,1672.9,14,2,0,12,8,16,1,1,0,0,18558,7.0,17422,202,40,1829,1132,20.2,1855.8
4526672320,0,12,2,0,2,4,3,1,1,0,0,14120,6.4,16943,217,51,-1443,-36,21.7,1412.0,12,2,1,4,2,5,1,0,1,0,15563,6.8,16979,214,51,1443,36,21.4,1556.3
4518069601,0,14,2,0,5,6,7,0,0,0,0,15078,6.6,16578,202,28,-1018,-828,20.2,1507.8,15,0,1,6,5,6,1,1,0,0,16096,6.8,17406,222,38,1018,828,22.2,1609.6
4490242391,0,19,3,1,9,6,15,1,1,0,0,17679,6.8,17322,222,32,363,-1888,22.2,1767.9,34,2,0,6,9,7,1,0,1,0,17316,7.2,19210,230,79,-363,1888,23.0,1731.6
4505315494,0,11,2,1,6,5,6,1,1,0,0,16186,7.0,18472,225,43,53,-114,22.5,1618.6,12,0,0,5,6,5,0,0,0,0,16133,6.8,18586,205,56,-53,114,20.5,1613.3
4499721373,0,18,4,1,6,5,5,1,1,0,1,17639,7.0,17826,247,48,1181,-683,24.7,1763.9,14,3,0,5,6,6,1,0,1,0,16458,7.2,18509,240,55,-1181,683,24.0,1645.8
4523808167,0,12,4,1,8,6,10,1,0,1,0,17012,7.0,17507,225,38,872,-215,22.5,1701.2,74,1,0,6,8,6,1,1,0,0,16140,6.8,17722,214,48,-872,215,21.4,1614.0
4423927997,0,41,3,1,4,9,1,1,0,1,0,15709,7.0,17814,207,52,-1696,-1748,20.7,1570.9,22,4,0,9,4,6,1,1,0,0,17405,7.2,19562,239,55,1696,1748,23.9,1740.5
4524808186,0,19,2,1,7,8,10,1,1,0,0,15719,6.4,16209,172,25,-833,-1553,17.2,1571.9,17,2,0,8,7,7,0,0,0,0,16552,6.8,17762,201,47,833,1553,20.1,1655.2
4466552109,0,26,1,1,3,5,3,1,1,0,0,15043,6.8,17227,225,47,-1591,-1829,22.5,1504.3,15,2,0,5,3,4,1,0,1,0,16634,7.4,19056,236,52,1591,1829,23.6,1663.4
4495005465,0,11,2,0,6,8,7,0,0,0,0,16924,6.8,17938,233,47,-465,-436,23.3,1692.4,81,1,1,8,6,10,0,0,0,0,17389,7.2,18374,214,42,465,436,21.4,1738.9
4396684519,0,16,3,0,8,6,13,1,1,0,0,17003,6.8,17843,222,43,253,-1300,22.2,1700.3,18,3,1,6,8,7,0,0,0,0,16750,7.2,19143,218,75,-253,1300,21.8,1675.0
4524635959,0,18,3,0,6,6,6,1,1,0,0,15571,6.8,16898,190,60,-1137,-982,19.0,1557.1,17,1,1,6,6,5,1,0,1,0,16708,7.0,17880,228,52,1137,982,22.8,1670.8
4483668263,0,13,0,1,6,4,6,1,0,1,0,16422,7.0,17507,212,53,-19,-1122,21.2,1642.2,11,1,0,4,6,2,0,0,0,0,16441,7.0,18629,256,68,19,1122,25.6,1644.1
4524787194,0,43,0,0,1,4,0,0,0,0,0,13046,6.2,15452,197,41,-2264,-964,19.7,1304.6,15,6,1,4,1,2,0,0,0,0,15310,6.6,16416,222,44,2264,964,22.2,1531.0
4521577993,0,16,2,0,7,9,6,0,0,0,0,16035,7.0,18455,180,55,-2691,-2196,18.0,1603.5,16,2,1,9,7,9,1,1,0,0,18726,7.6,20651,243,63,2691,2196,24.3,1872.6
4502459201,0,15,1,1,3,12,2,0,0,0,0,15853,7.0,18223,220,68,-2388,-1978,22.0,1585.3,18,1,0,12,3,8,2,1,1,0,18241,7.6,20201,205,56,2388,1978,20.5,1824.1
4505381555,0,15,1,0,5,7,12,1,1,0,0,15218,6.4,16410,198,44,-2060,-2850,19.8,1521.8,18,1,1,7,5,6,0,0,0,0,17278,7.2,19260,240,47,2060,2850,24.0,1727.8
4514740327,0,14,2,1,5,7,7,0,0,0,0,17224,6.8,18105,229,60,631,-265,22.9,1722.4,84,2,0,7,5,6,1,1,0,0,16593,7.2,18370,218,46,-631,265,21.8,1659.3
4525329096,0,13,4,1,2,4,2,0,0,0,0,14842,7.0,17857,231,48,270,679,23.1,1484.2,17,2,0,4,2,3,1,1,0,0,14572,6.8,17178,193,41,-270,-679,19.3,1457.2
4459480413,0,15,1,0,4,6,5,0,0,0,0,15506,6.8,17710,231,50,-672,-1420,23.1,1550.6,12,1,1,6,4,4,1,1,0,0,16178,7.2,19130,214,49,672,1420,21.4,1617.8
4516493520,0,12,3,0,2,5,3,0,0,0,0,14777,6.8,17450,215,51,-1276,-1016,21.5,1477.7,14,1,1,5,2,1,2,1,1,0,16053,7.2,18466,241,55,1276,1016,24.1,1605.3
4497887298,0,68,0,0,1,14,1,1,1,0,0,13438,5.8,14164,174,53,-7655,-4485,17.4,1343.8,15,4,1,14,1,18,0,0,0,1,21093,7.0,18649,234,29,7655,4485,23.4,2109.3
4500313763,0,15,0,0,6,7,3,1,0,1,0,16132,7.0,18044,222,52,-1989,-735,22.2,1613.2,15,5,1,7,6,6,1,1,0,1,18121,7.4,18779,218,52,1989,735,21.8,1812.1
4497854220,0,17,2,0,9,5,12,1,1,0,0,17525,7.0,19083,221,40,1270,365,22.1,1752.5,34,5,1,5,9,2,0,0,0,0,16255,7.4,18718,218,60,-1270,-365,21.8,1625.5
4522686444,0,16,1,1,6,5,4,0,0,0,0,16682,7.0,18272,236,52,598,374,23.6,1668.2,14,4,0,5,6,5,1,1,0,0,16084,6.8,17898,235,60,-598,-374,23.5,1608.4
4440187029,0,86,2,0,2,4,1,0,0,0,0,14291,7.0,18239,207,65,-2609,-1786,20.7,1429.1,15,4,1,4,2,3,1,1,0,0,16900,7.6,20025,259,76,2609,1786,25.9,1690.0
4525932869,0,19,4,1,8,14,9,1,1,0,0,16227,6.6,16987,197,48,-3055,-2672,19.7,1622.7,19,2,0,14,8,15,0,0,0,0,19282,7.2,19659,214,44,3055,2672,21.4,1928.2
4520670087,0,18,0,0,10,4,6,0,0,0,0,17125,7.0,17861,210,40,1294,453,21.0,1712.5,14,3,1,4,10,3,1,1,0,0,15831,7.0,17408,223,56,-1294,-453,22.3,1583.1
4525363393,0,12,4,0,4,8,5,1,0,1,0,15384,6.8,17460,211,44,-1817,-1035,21.1,1538.4,17,0,1,8,4,6,1,1,0,0,17201,7.0,18495,240,48,1817,1035,24.0,1720.1
4526481704,0,16,0,0,6,7,8,0,0,0,0,15779,6.8,17436,186,31,-1219,-737,18.6,1577.9,14,3,1,7,6,10,2,1,1,0,16998,7.2,18173,242,52,1219,737,24.2,1699.8
4512340309,0,12,2,1,10,9,14,0,0,0,0,18178,7.0,17725,213,34,342,-646,21.3,1817.8,15,1,0,9,10,8,1,1,0,0,17836,7.0,18371,222,54,-342,646,22.2,1783.6
4504690323,0,20,2,0,2,6,2,2,1,1,0,15488,6.8,18660,265,67,-978,-226,26.5,1548.8,20,2,1,6,2,8,0,0,0,0,16466,7.2,18886,220,43,978,226,22.0,1646.6
4522346713,0,15,2,0,2,5,0,1,0,1,0,13418,6.4,16047,189,52,-2958,-1733,18.9,1341.8,9,3,1,5,2,5,1,1,0,0,16376,7.0,17780,220,63,2958,1733,22.0,1637.6
4519801172,0,16,2,1,3,16,5,0,0,0,0,14316,6.2,14965,195,44,-5219,-4005,19.5,1431.6,14,4,0,16,3,23,1,1,0,0,19535,7.2,18970,183,48,5219,4005,18.3,1953.5
4515957232,0,52,2,0,2,10,1,0,0,0,0,14817,6.4,16953,212,60,-3264,-1507,21.2,1481.7,16,2,1,10,2,11,1,1,0,0,18081,7.0,18460,211,40,3264,1507,21.1,1808.1
4518349357,0,13,2,1,8,8,10,0,0,0,0,17850,7.4,19495,256,54,30,-249,25.6,1785.0,13,1,0,8,8,7,1,1,0,0,17820,7.2,19744,234,68,-30,249,23.4,1782.0
4526660217,0,12,4,1,6,5,10,0,0,0,0,16532,6.6,16932,213,58,1920,1140,21.3,1653.2,17,1,0,5,6,9,1,1,0,0,14612,6.4,15792,155,52,-1920,-1140,15.5,1461.2
4510540123,0,32,2,1,8,9,7,1,0,1,0,17258,7.0,18755,214,40,-978,78,21.4,1725.8,12,1,0,9,8,8,1,1,0,0,18236,7.2,18677,207,61,978,-78,20.7,1823.6
4494516063,0,16,5,1,9,7,5,1,1,0,0,17907,7.2,19438,231,49,1550,2512,23.1,1790.7,46,4,0,7,9,10,0,0,0,0,16357,6.6,16926,192,40,-1550,-2512,19.2,1635.7
4496613517,0,17,4,1,9,10,5,0,0,0,0,17193,7.0,18326,224,40,-1027,-1434,22.4,1719.3,16,2,0,10,9,6,0,0,0,0,18220,7.6,19760,236,56,1027,1434,23.6,1822.0
4457658840,0,16,2,0,3,7,5,0,0,0,0,15442,6.6,17224,237,47,-2109,-1475,23.7,1544.2,20,4,1,7,3,10,1,1,0,0,17551,7.2,18699,233,50,2109,1475,23.3,1755.1
4485957777,0,18,2,0,3,8,1,0,0,0,0,14496,6.8,16623,230,48,-2317,-1330,23.0,1449.6,17,4,1,8,3,11,2,1,1,0,16813,7.0,17953,223,44,2317,1330,22.3,1681.3
4500702645,0,20,5,0,6,5,10,0,0,0,0,17160,7.0,18228,241,47,1497,717,24.1,1716.0,17,7,1,5,6,4,1,1,0,0,15663,6.8,17511,218,40,-1497,-717,21.8,1566.3
4499740164,0,14,2,0,8,10,4,0,0,0,0,15229,6.4,16071,213,4,-4493,-3830,21.3,1522.9,13,2,1,10,8,10,2,1,1,1,19722,7.4,19901,218,68,4493,3830,21.8,1972.2
4477654399,0,20,4,0,4,6,4,1,0,1,0,15888,7.4,18421,234,65,-205,1064,23.4,1588.8,18,2,1,6,4,7,0,0,0,0,16093,7.0,17357,217,32,205,-1064,21.7,1609.3
4524785732,0,11,2,0,1,9,1,0,0,0,0,14672,6.6,16566,234,58,-2998,-3331,23.4,1467.2,56,1,1,9,1,10,0,0,0,0,17670,7.2,19897,251,50,2998,3331,25.1,1767.0
4522608036,0,22,4,0,7,2,5,0,0,0,0,16696,7.2,18900,225,68,1945,2614,22.5,1669.6,17,4,1,2,7,3,0,0,0,0,14751,6.4,16286,196,52,-1945,-2614,19.6,1475.1
4520393840,0,18,3,1,9,7,13,1,1,0,0,17682,6.6,17214,195,51,724,241,19.5,1768.2,40,3,0,7,9,9,0,0,0,0,16958,6.6,16973,229,48,-724,-241,22.9,1695.8
4527576450,0,13,2,0,4,8,3,0,0,0,0,14668,6.6,16865,193,32,-2958,-1446,19.3,1466.8,15,2,1,8,4,9,1,1,0,0,17626,7.0,18311,232,43,2958,1446,23.2,1762.6
4511647215,0,13,3,0,5,7,8,1,0,1,0,15457,6.6,17048,191,58,-1647,-3035,19.1,1545.7,13,4,1,7,5,7,1,1,0,0,17104,7.4,20083,251,54,1647,3035,25.1,1710.4
4450519397,0,20,7,1,7,4,12,2,1,1,0,16431,6.8,17901,204,54,617,866,20.4,1643.1,19,5,0,4,7,6,0,0,0,0,15814,6.6,17035,236,52,-617,-866,23.6,1581.4
4522051549,0,16,3,1,8,11,8,0,0,0,0,17739,6.6,16482,215,55,377,-597,21.5,1773.9,22,4,0,11,8,12,2,1,1,0,17362,6.8,17079,197,44,-377,597,19.7,1736.2
4474977192,0,16,1,0,5,11,4,0,0,0,0,16105,6.8,17502,214,35,-2047,-2555,21.4,1610.5,141,1,1,11,5,5,1,1,0,0,18152,7.6,20057,208,52,2047,2555,20.8,1815.2
4515658862,0,36,5,0,2,7,2,1,0,1,0,15279,7.0,18355,236,59,-1526,-1082,23.6,1527.9,14,6,1,7,2,10,1,1,0,0,16805,7.4,19437,236,40,1526,1082,23.6,1680.5
4523830779,0,14,1,1,6,10,5,0,0,0,0,17250,7.0,18266,222,60,-862,-1596,22.2,1725.0,11,1,0,10,6,11,0,0,0,0,18112,7.4,19862,216,43,862,1596,21.6,1811.2
4523553248,0,16,11,1,6,7,3,1,1,0,0,15829,7.0,18055,228,48,-464,-47,22.8,1582.9,43,9,0,7,6,8,0,0,0,0,16293,7.0,18102,208,42,464,47,20.8,1629.3
4508799879,0,10,3,0,3,6,5,1,0,1,0,15521,6.6,16916,202,60,-1187,-714,20.2,1552.1,72,1,1,6,3,6,1,1,0,0,16708,7.0,17630,219,53,1187,714,21.9,1670.8
4519053243,0,16,2,1,9,12,15,0,0,0,0,16494,6.2,15865,156,40,-1484,-1528,15.6,1649.4,16,0,0,12,9,14,1,1,0,0,17978,6.6,17393,196,56,1484,1528,19.6,1797.8
4525128614,0,24,2,1,8,8,9,0,0,0,0,17238,6.8,17944,209,44,894,-3,20.9,1723.8,15,2,0,8,8,10,0,0,0,0,16344,7.0,17947,187,44,-894,3,18.7,1634.4
4521333183,0,17,1,0,1,2,2,0,0,0,0,13863,6.8,17182,219,40,-1336,-1242,21.9,1386.3,16,3,1,2,1,1,1,1,0,0,15199,7.0,18424,226,75,1336,1242,22.6,1519.9
4467412400,0,17,1,1,1,3,1,0,0,0,0,15573,7.0,18440,246,70,66,319,24.6,1557.3,130,4,0,3,1,6,2,1,1,0,15507,7.0,18121,233,57,-66,-319,23.3,1550.7
4448485009,0,14,4,0,0,15,0,0,0,0,0,12971,6.4,14675,181,56,-6850,-6210,18.1,1297.1,18,3,1,15,0,16,1,1,0,0,19821,7.6,20885,236,40,6850,6210,23.6,1982.1
4522083891,0,14,5,1,12,9,10,1,1,0,0,18910,7.2,18538,203,47,1454,1187,20.3,1891.0,15,1,0,9,12,14,0,0,0,0,17456,7.0,17351,185,40,-1454,-1187,18.5,1745.6
4520889753,0,16,5,1,6,7,9,1,1,0,0,15303,6.6,16803,209,28,-1154,-1629,20.9,1530.3,21,1,0,7,6,8,0,0,0,0,16457,7.0,18432,207,44,1154,1629,20.7,1645.7
4518559997,0,17,0,1,4,5,3,2,1,1,0,16018,7.2,18223,215,68,-599,192,21.5,1601.8,17,5,0,5,4,10,0,0,0,0,16617,6.8,18031,242,48,599,-192,24.2,1661.7
4524919895,0,19,4,1,12,7,13,2,1,1,0,17810,6.6,16753,150,50,532,-883,15.0,1781.0,16,4,0,7,12,8,0,0,0,0,17278,6.8,17636,255,28,-532,883,25.5,1727.8
4477340034,0,20,2,0,3,6,3,1,0,1,0,14840,6.8,17620,226,56,-2579,-626,22.6,1484.0,15,5,1,6,3,9,0,0,0,0,17419,7.0,18246,245,56,2579,626,24.5,1741.9
4505180812,0,16,5,1,6,3,6,1,1,0,0,16928,7.2,18438,236,52,1071,-35,23.6,1692.8,18,3,0,3,6,0,0,0,0,0,15857,7.2,18473,254,71,-1071,35,25.4,1585.7
4476404495,0,17,2,0,4,7,2,1,1,0,0,15974,6.8,17188,227,48,-836,-839,22.7,1597.4,20,5,1,7,4,10,0,0,0,0,16810,6.8,18027,217,40,836,839,21.7,1681.0
4518453664,0,48,0,0,6,5,6,0,0,0,0,15904,6.8,17623,201,48,-73,217,20.1,1590.4,15,4,1,5,6,6,2,1,1,0,15977,6.6,17406,228,48,73,-217,22.8,1597.7
4506010856,0,16,2,1,3,7,2,0,0,0,0,16025,7.0,17956,214,56,-44,-357,21.4,1602.5,105,4,0,7,3,5,1,1,0,0,16069,7.0,18313,220,44,44,357,22.0,1606.9
4492179998,0,15,2,0,4,7,3,1,1,0,0,14622,6.6,17798,176,67,-2542,-388,17.6,1462.2,15,3,1,7,4,10,0,0,0,0,17164,7.0,18186,238,48,2542,388,23.8,1716.4
4509907014,0,19,13,1,3,2,6,1,0,1,0,15840,6.6,16848,212,40,1811,-631,21.2,1584.0,43,4,0,2,3,1,1,1,0,0,14029,6.8,17479,221,48,-1811,631,22.1,1402.9
4505269056,0,14,3,0,4,6,5,1,1,0,0,15382,7.0,17876,218,56,-1182,-944,21.8,1538.2,18,1,1,6,4,4,1,0,1,0,16564,7.0,18820,207,54,1182,944,20.7,1656.4
4494291164,0,17,1,0,6,4,7,0,0,0,0,16091,7.0,18518,238,38,356,122,23.8,1609.1,14,4,1,4,6,4,1,1,0,0,15735,7.0,18396,217,64,-356,-122,21.7,1573.5
4495602033,0,18,1,0,7,8,8,0,0,0,0,17472,6.8,18276,229,52,-214,-356,22.9,1747.2,13,3,1,8,7,9,2,1,1,0,17686,7.0,18632,211,52,214,356,21.1,1768.6
4526069179,0,15,2,1,6,6,7,1,1,0,0,16148,6.8,15943,200,45,-1106,-1434,20.0,1614.8,15,2,0,6,6,9,1,0,1,0,17254,6.6,17377,216,70,1106,1434,21.6,1725.4
4526920856,0,25,1,0,4,5,3,1,1,0,0,15791,7.0,18218,220,56,-478,346,22.0,1579.1,17,2,1,5,4,4,0,0,0,0,16269,7.0,17872,247,42,478,-346,24.7,1626.9
4473009756,0,13,2,0,7,7,10,1,1,0,0,16397,6.6,17090,222,40,-1023,-2028,22.2,1639.7,39,1,1,7,7,6,0,0,0,0,17420,7.2,19118,243,52,1023,2028,24.3,1742.0
4522097208,0,15,2,1,6,3,7,1,1,0,0,16067,6.4,16652,218,42,841,-1456,21.8,1606.7,18,5,0,3,6,1,0,0,0,0,15226,7.0,18108,246,53,-841,1456,24.6,1522.6
4520801311,0,13,13,1,8,7,12,1,1,0,0,17018,7.0,17105,190,56,1096,120,19.0,1701.8,41,2,0,7,8,4,0,0,0,0,15922,6.8,16985,196,47,-1096,-120,19.6,1592.2
4467826784,0,17,0,0,9,10,8,1,1,0,0,16690,6.6,17356,215,44,170,1174,21.5,1669.0,11,1,1,10,9,8,0,0,0,0,16520,6.4,16182,189,36,-170,-1174,18.9,1652.0
4462548167,0,14,2,1,5,9,7,1,1,0,0,15530,6.8,17375,220,60,-2141,-52,22.0,1553.0,40,7,0,9,5,12,1,0,1,0,17671,6.8,17427,236,35,2141,52,23.6,1767.1
4514094698,0,31,20,0,7,7,6,1,1,0,0,16063,6.8,17688,192,60,-1571,-1130,19.2,1606.3,47,6,1,7,7,6,0,0,0,0,17634,7.2,18818,260,60,1571,1130,26.0,1763.4
4491128143,0,13,1,0,4,8,4,0,0,0,0,15676,7.2,19519,223,63,-2476,-394,22.3,1567.6,19,3,1,8,4,7,2,1,1,0,18152,7.4,19913,260,64,2476,394,26.0,1815.2
4523702225,0,19,3,1,10,7,9,1,0,1,0,17619,7.2,18563,186,49,1273,622,18.6,1761.9,16,2,0,7,10,4,1,1,0,0,16346,7.0,17941,186,57,-1273,-622,18.6,1634.6
4516987544,0,13,3,1,3,3,3,0,0,0,0,16064,7.2,18651,247,56,1117,472,24.7,1606.4,17,2,0,3,3,0,2,1,1,0,14947,6.8,18179,229,54,-1117,-472,22.9,1494.7
4502271780,0,9,2,0,4,8,2,0,0,0,0,15901,6.8,18288,233,55,-1333,284,23.3,1590.1,14,0,1,8,4,13,1,1,0,0,17234,7.0,18004,214,40,1333,-284,21.4,1723.4
4524156095,0,16,3,1,6,5,6,0,0,0,0,16518,7.2,19187,223,56,51,140,22.3,1651.8,16,2,0,5,6,6,1,1,0,0,16467,7.2,19047,245,44,-51,-140,24.5,1646.7
4518919101,0,11,3,0,5,8,9,0,0,0,0,15388,6.4,15598,179,39,-4104,-3458,17.9,1538.8,16,3,1,8,5,8,0,0,0,1,19492,7.2,19056,264,55,4104,3458,26.4,1949.2
4455505854,0,41,6,1,9,4,10,1,1,0,0,17405,6.8,18506,187,46,1996,860,18.7,1740.5,20,5,0,4,9,3,0,0,0,0,15409,7.0,17646,236,40,-1996,-860,23.6,1540.9
4509558169,0,18,3,0,7,7,4,0,0,0,0,16581,7.0,18360,198,54,462,1726,19.8,1658.1,12,2,1,7,7,8,0,0,0,0,16119,6.6,16634,200,47,-462,-1726,20.0,1611.9
4497742597,0,60,3,0,7,4,10,1,1,0,0,16641,7.0,18150,221,51,1459,970,22.1,1664.1,14,2,1,4,7,2,0,0,0,0,15182,6.8,17180,210,52,-1459,-970,21.0,1518.2
4459612181,0,11,4,0,2,7,3,0,0,0,0,14313,6.4,16259,212,57,-2276,-2192,21.2,1431.3,15,0,1,7,2,7,1,1,0,0,16589,6.8,18451,217,47,2276,2192,21.7,1658.9
4453038156,0,33,2,1,11,11,7,1,0,1,0,16695,7.0,18507,157,40,-1505,-635,15.7,1669.5,17,1,0,11,11,9,0,0,0,0,18200,7.0,19142,188,52,1505,635,18.8,1820.0
4527547442,0,13,5,0,2,11,2,0,0,0,0,13794,6.4,15813,190,55,-4192,-3984,19.0,1379.4,41,2,1,11,2,9,1,1,0,0,17986,7.2,19797,220,56,4192,3984,22.0,1798.6
4515338642,0,19,2,0,3,4,2,0,0,0,0,14564,6.6,17178,214,43,-1999,-647,21.4,1456.4,21,6,1,4,3,5,1,1,0,0,16563,7.0,17825,238,64,1999,647,23.8,1656.3
4506779668,0,39,3,0,4,7,4,1,1,0,0,15722,6.8,17329,221,53,-3309,-2741,22.1,1572.2,17,5,1,7,4,9,0,0,0,1,19031,7.4,20070,230,60,3309,2741,23.0,1903.1
4526423830,0,16,0,1,10,9,10,0,0,0,0,18034,6.8,17170,211,43,1179,-675,21.1,1803.4,16,2,0,9,10,11,0,0,0,0,16855,7.0,17845,222,32,-1179,675,22.2,1685.5
4512949198,0,15,4,1,5,10,5,1,1,0,0,15714,6.8,17362,208,59,-3095,-2200,20.8,1571.4,16,3,0,10,5,12,0,0,0,0,18809,7.2,19562,244,40,3095,2200,24.4,1880.9
4516721414,0,18,4,1,8,8,8,1,1,0,0,16453,6.8,17231,206,40,-569,-213,20.6,1645.3,21,2,0,8,8,10,1,0,1,0,17022,7.0,17444,199,43,569,213,19.9,1702.2
4494347491,0,17,2,1,4,5,2,0,0,0,0,15598,7.0,18672,204,72,-518,868,20.4,1559.8,17,4,0,5,4,10,0,0,0,0,16116,7.0,17804,225,40,518,-868,22.5,1611.6
4497491291,0,15,3,0,4,6,6,1,0,1,1,16580,7.0,17438,205,45,-551,-551,20.5,1658.0,54,2,1,6,4,10,1,1,0,0,17131,6.8,17989,218,55,551,551,21.8,1713.1
4492250541,0,10,2,1,6,8,7,1,1,0,0,14779,6.2,15595,137,44,-2932,-2570,13.7,1477.9,13,2,0,8,6,5,1,0,1,0,17711,7.2,18165,219,52,2932,2570,21.9,1771.1
4464836293,0,16,5,0,4,5,7,0,0,0,0,15858,6.8,17491,246,44,-512,-844,24.6,1585.8,20,3,1,5,4,6,2,1,1,0,16370,7.0,18335,241,52,512,844,24.1,1637.0
4521939526,0,13,3,0,1,7,0,0,0,0,0,13828,6.6,16964,228,53,-3588,-2501,22.8,1382.8,17,2,1,7,1,6,0,0,0,0,17416,7.2,19465,258,60,3588,2501,25.8,1741.6
4415176080,0,12,2,1,8,6,6,0,0,0,0,17040,7.2,18469,230,56,1740,929,23.0,1704.0,14,2,0,6,8,5,1,1,0,0,15300,6.8,17540,198,48,-1740,-929,19.8,1530.0
4522652739,0,16,4,1,4,2,3,2,1,1,0,16125,7.2,19055,235,56,1236,144,23.5,1612.5,28,4,0,2,4,2,0,0,0,0,14889,7.4,18911,249,60,-1236,-144,24.9,1488.9
4484490025,0,16,1,0,5,12,6,0,0,0,0,15782,6.4,16172,195,44,-2707,-2136,19.5,1578.2,19,3,1,12,5,10,1,1,0,0,18489,7.0,18308,233,40,2707,2136,23.3,1848.9
4499846213,0,94,3,1,6,9,9,1,1,0,0,16447,6.6,16299,208,48,-1942,-2662,20.8,1644.7,14,5,0,9,6,14,0,0,0,0,18389,7.0,18961,239,52,1942,2662,23.9,1838.9
4527162732,0,89,5,0,7,4,9,0,0,0,0,16860,7.0,17641,218,48,1293,-262,21.8,1686.0,14,1,1,4,7,2,0,0,0,0,15567,6.8,17903,219,55,-1293,262,21.9,1556.7
4470700063,0,22,6,1,3,8,4,0,0,0,0,15032,6.8,16226,221,48,-2798,-2403,22.1,1503.2,17,3,0,8,3,5,2,1,1,1,17830,7.0,18629,215,60,2798,2403,21.5,1783.0
4516962004,0,14,3,0,5,8,8,1,1,0,0,17160,7.2,19481,245,64,-312,37,24.5,1716.0,15,1,1,8,5,12,0,0,0,0,17472,7.2,19444,231,60,312,-37,23.1,1747.2
4483620406,0,19,2,0,3,6,1,1,0,1,0,14499,7.0,18406,201,68,-3079,-1816,20.1,1449.9,13,4,1,6,3,4,1,1,0,0,17578,7.2,20222,245,63,3079,1816,24.5,1757.8
4494291659,0,13,0,1,1,7,2,0,0,0,0,13099,5.8,14520,191,28,-3521,-4416,19.1,1309.9,15,1,0,7,1,8,1,1,0,0,16620,7.2,18936,247,44,3521,4416,24.7,1662.0
4500400815,0,8,1,1,4,12,4,0,0,0,0,14370,6.4,15153,167,38,-5228,-6488,16.7,1437.0,55,2,0,12,4,9,0,0,0,0,19598,7.8,21641,250,69,5228,6488,25.0,1959.8
4448166002,0,19,3,1,2,11,2,0,0,0,0,14959,6.8,16588,226,54,-3301,-2246,22.6,1495.9,16,2,0,11,2,18,1,1,0,0,18260,7.4,18834,203,53,3301,2246,20.3,1826.0
4524584974,0,15,2,0,4,11,3,0,0,0,0,14956,6.4,16656,216,49,-3532,-2062,21.6,1495.6,17,2,1,11,4,11,0,0,0,0,18488,7.2,18718,217,56,3532,2062,21.7,1848.8
4520641645,0,25,3,0,6,1,8,1,1,0,0,16129,7.2,18567,210,48,2279,2842,21.0,1612.9,17,2,1,1,6,1,0,0,0,0,13850,6.4,15725,205,39,-2279,-2842,20.5,1385.0
4515801443,0,13,1,1,4,1,5,2,1,1,0,15869,7.2,18711,249,64,453,76,24.9,1586.9,20,4,0,1,4,1,0,0,0,0,15416,7.0,18635,265,68,-453,-76,26.5,1541.6
4517169650,0,26,3,0,2,5,5,0,0,0,0,14531,6.8,16999,222,56,-1711,-2183,22.2,1453.1,15,4,1,5,2,5,1,1,0,0,16242,7.2,19182,235,52,1711,2183,23.5,1624.2
4489524700,0,12,0,1,7,8,6,1,1,0,0,17011,7.2,18754,231,48,-2215,-138,23.1,1701.1,13,0,0,8,7,13,1,0,1,2,19226,7.0,18892,206,62,2215,138,20.6,1922.6
4519004936,0,11,0,1,5,9,2,0,0,0,0,14681,6.8,17137,174,44,-2985,-3019,17.4,1468.1,9,0,0,9,5,8,1,1,0,0,17666,7.6,20156,213,55,2985,3019,21.3,1766.6
4489934544,0,15,4,0,6,8,4,1,0,1,0,16860,7.2,19037,239,51,-259,357,23.9,1686.0,16,1,1,8,6,6,0,0,0,0,17119,7.2,18680,238,49,259,-357,23.8,1711.9
4484733667,0,16,2,1,3,3,4,0,0,0,0,14951,6.8,17903,225,44,-1036,-942,22.5,1495.1,17,1,0,3,3,3,1,1,0,0,15987,7.2,18845,252,58,1036,942,25.2,1598.7
4516772132,0,16,2,1,2,5,1,1,0,1,1,15951,7.0,18136,236,42,-675,-1212,23.6,1595.1,17,3,0,5,2,6,0,0,0,0,16626,7.2,19348,234,60,675,1212,23.4,1662.6
4518203153,0,21,7,0,6,4,8,0,0,0,0,15840,6.8,16689,204,48,-376,-1118,20.4,1584.0,19,5,1,4,6,4,0,0,0,0,16216,6.8,17807,228,43,376,1118,22.8,1621.6
4526390951,0,12,1,0,2,9,2,0,0,0,0,14606,6.8,17633,200,71,-3513,-1630,20.0,1460.6,14,0,1,9,2,6,1,1,0,0,18119,7.4,19263,221,60,3513,1630,22.1,1811.9
4509680666,0,16,2,0,4,14,2,0,0,0,0,14450,6.4,15750,186,38,-4637,-3355,18.6,1445.0,15,4,1,14,4,19,0,0,0,0,19087,7.2,19105,210,54,4637,3355,21.0,1908.7
4526431738,0,12,4,0,3,8,3,0,0,0,0,14264,6.2,15870,201,28,-2234,-2021,20.1,1426.4,16,2,1,8,3,6,1,1,0,0,16498,6.8,17891,204,56,2234,2021,20.4,1649.8
4508717967,0,18,2,0,15,6,15,0,0,0,0,19931,7.0,18115,213,40,4375,3249,21.3,1993.1,17,1,1,6,15,6,0,0,0,0,15556,6.2,14866,169,40,-4375,-3249,16.9,1555.6
4524429055,0,19,2,1,4,0,2,2,1,1,0,16124,7.4,18986,244,76,2186,1319,24.4,1612.4,18,3,0,0,4,0,0,0,0,0,13938,6.8,17667,241,51,-2186,-1319,24.1,1393.8
4523893279,0,15,2,0,5,10,8,1,1,0,0,15269,6.6,16739,194,37,-2793,-1055,19.4,1526.9,15,1,1,10,5,13,0,0,0,0,18062,6.8,17794,204,45,2793,1055,20.4,1806.2
4516971846,0,15,4,0,1,3,2,0,0,0,0,15196,6.8,17168,262,40,52,-934,26.2,1519.6,15,3,1,3,1,2,1,0,1,0,15144,7.0,18102,246,47,-52,934,24.6,1514.4
4494516149,0,37,3,0,4,7,4,1,0,1,0,16388,7.0,17168,220,50,-420,-1518,22.0,1638.8,14,4,1,7,4,10,0,0,0,0,16808,7.2,18686,239,37,420,1518,23.9,1680.8
4477419321,0,16,3,1,7,6,6,0,0,0,0,16254,6.8,17374,200,47,-908,-1806,20.0,1625.4,21,3,0,6,7,8,0,0,0,0,17162,7.2,19180,227,52,908,1806,22.7,1716.2
4519154901,0,16,1,1,2,6,0,0,0,0,0,14072,6.6,16596,207,56,-2186,-1093,20.7,1407.2,37,1,0,6,2,7,1,1,0,0,16258,7.0,17689,210,54,2186,1093,21.0,1625.8
4489837555,0,41,2,0,5,4,7,1,1,0,0,16412,7.2,18935,223,44,980,1536,22.3,1641.2,13,4,1,4,5,5,0,0,0,0,15432,6.8,17399,232,38,-980,-1536,23.2,1543.2
4520625705,0,12,0,0,6,9,4,1,0,1,1,16829,6.8,17978,198,48,-489,188,19.8,1682.9,21,0,1,9,6,11,1,1,0,0,17318,6.8,17790,216,47,489,-188,21.6,1731.8
4519740726,0,14,1,1,6,7,5,0,0,0,0,16688,6.8,17793,213,44,-214,-334,21.3,1668.8,36,2,0,7,6,8,1,1,0,0,16902,7.0,18127,201,71,214,334,20.1,1690.2
4526510226,0,16,3,1,2,4,4,0,0,0,0,14775,6.8,17337,206,45,-1285,-1925,20.6,1477.5,59,3,0,4,2,7,1,0,1,0,16060,7.2,19262,227,63,1285,1925,22.7,1606.0
4500905906,0,30,3,0,6,4,4,1,1,0,0,16017,7.2,17471,208,51,1598,2478,20.8,1601.7,17,2,1,4,6,6,0,0,0,0,14419,6.2,14993,194,34,-1598,-2478,19.4,1441.9
4296354535,0,16,5,1,12,3,14,1,1,0,0,19031,7.4,18999,234,40,4188,2399,23.4,1903.1,19,1,0,3,12,2,1,0,1,0,14843,6.6,16600,207,52,-4188,-2399,20.7,1484.3
4514470040,0,11,1,0,3,10,1,0,0,0,0,14637,6.6,17059,210,55,-3368,-2587,21.0,1463.7,36,1,1,10,3,10,1,1,0,0,18005,7.4,19646,236,41,3368,2587,23.6,1800.5
4523517991,0,12,2,0,2,14,0,0,0,0,0,13229,6.4,15040,177,46,-6460,-5383,17.7,1322.9,14,4,1,14,2,11,0,0,0,0,19689,7.4,20423,233,44,6460,5383,23.3,1968.9
4518945702,0,15,2,0,1,4,1,1,1,0,0,13934,6.8,17303,222,55,-1571,-693,22.2,1393.4,15,0,1,4,1,6,0,0,0,0,15505,7.0,17996,191,61,1571,693,19.1,1550.5
4523109527,0,91,2,1,3,5,3,0,0,0,0,15001,7.0,17799,218,48,-685,-1871,21.8,1500.1,16,3,0,5,3,2,1,0,1,0,15686,7.2,19670,214,64,685,1871,21.4,1568.6
4473252742,0,14,0,0,7,9,5,0,0,0,0,16474,6.6,17408,209,50,-1559,-407,20.9,1647.4,22,4,1,9,7,13,1,1,0,0,18033,6.8,17815,206,53,1559,407,20.6,1803.3
4522814344,0,17,4,1,2,4,3,0,0,0,0,14615,7.0,18302,221,47,-1530,-1114,22.1,1461.5,16,4,0,4,2,5,1,1,0,0,16145,7.4,19416,243,71,1530,1114,24.3,1614.5
4448127170,0,34,7,1,2,3,3,1,0,1,0,15345,7.2,18848,230,64,-164,1358,23.0,1534.5,19,3,0,3,2,7,1,1,0,0,15509,6.6,17490,236,55,164,-1358,23.6,1550.9
4514158215,0,34,1,1,9,5,10,1,1,0,0,16915,7.0,17888,198,55,649,-103,19.8,1691.5,12,2,0,5,9,5,0,0,0,0,16266,6.8,17991,197,60,-649,103,19.7,1626.6
4517942956,0,53,1,0,2,6,0,0,0,0,0,13888,6.4,15518,172,52,-3220,-4094,17.2,1388.8,14,3,1,6,2,6,1,0,1,0,17108,7.4,19612,242,52,3220,4094,24.2,1710.8
4504961741,0,14,3,0,2,7,2,0,0,0,0,15461,6.8,17683,206,60,-1912,-2257,20.6,1546.1,16,2,1,7,2,7,2,1,1,0,17373,7.2,19940,243,55,1912,2257,24.3,1737.3
4484373881,0,17,1,1,6,4,8,2,1,1,0,17249,7.0,18964,239,56,1095,768,23.9,1724.9,12,4,0,4,6,6,0,0,0,0,16154,7.0,18196,247,56,-1095,-768,24.7,1615.4
4500743979,0,13,2,0,2,10,1,0,0,0,0,14227,6.6,16822,205,44,-2617,-2322,20.5,1422.7,15,1,1,10,2,11,1,1,0,0,16844,7.2,19144,208,40,2617,2322,20.8,1684.4
4473903480,0,14,4,0,6,7,3,0,0,0,0,15827,6.6,17709,218,47,-1694,-603,21.8,1582.7,13,2,1,7,6,6,1,0,1,0,17521,7.0,18312,239,50,1694,603,23.9,1752.1
4513856190,0,37,3,1,4,6,6,0,0,0,0,15871,6.8,17242,224,56,-752,-1764,22.4,1587.1,14,10,0,6,4,4,2,1,1,0,16623,7.0,19006,228,72,752,1764,22.8,1662.3
4490249955,0,30,3,0,8,5,9,0,0,0,0,16984,7.2,18842,225,60,1229,1913,22.5,1698.4,15,2,1,5,8,3,0,0,0,0,15755,6.8,16929,214,36,-1229,-1913,21.4,1575.5
4440516925,0,23,3,0,9,7,11,0,0,0,0,17616,7.0,18731,195,73,356,565,19.5,1761.6,39,7,1,7,9,8,0,0,0,0,17260,7.0,18166,208,55,-356,-565,20.8,1726.0
4526037570,0,16,0,1,7,4,10,1,1,0,0,16339,7.0,17365,224,40,457,-959,22.4,1633.9,10,1,0,4,7,3,1,0,1,0,15882,7.0,18324,254,56,-457,959,25.4,1588.2
4520879353,0,53,2,0,3,6,3,0,0,0,0,14782,6.8,17600,238,44,-1454,-1276,23.8,1478.2,42,4,1,6,3,6,1,1,0,0,16236,7.2,18876,204,63,1454,1276,20.4,1623.6
4481630032,0,18,1,1,5,1,6,1,1,0,0,15381,7.0,17703,211,51,759,657,21.1,1538.1,15,6,0,1,5,0,0,0,0,0,14622,6.8,17046,245,50,-759,-657,24.5,1462.2
4527229646,0,42,2,0,5,6,3,0,0,0,0,16225,7.0,18754,219,54,-38,1167,21.9,1622.5,15,0,1,6,5,8,0,0,0,0,16263,6.8,17587,239,32,38,-1167,23.9,1626.3
4512990467,0,18,3,1,7,11,9,1,0,1,0,17132,6.6,16777,198,56,-2250,-1591,19.8,1713.2,17,5,0,11,7,17,1,1,0,0,19382,7.0,18368,196,52,2250,1591,19.6,1938.2
4526693928,0,13,4,0,3,12,2,0,0,0,0,15001,6.8,17600,228,51,-4625,-1892,22.8,1500.1,11,1,1,12,3,16,1,1,0,0,19626,7.2,19492,247,47,4625,1892,24.7,1962.6
4459848079,0,16,4,0,2,9,2,0,0,0,0,13791,6.6,16220,199,50,-4379,-3811,19.9,1379.1,15,3,1,9,2,6,0,0,0,0,18170,7.4,20031,250,54,4379,3811,25.0,1817.0
4495003373,0,22,4,0,5,7,3,1,0,1,0,15475,7.0,18145,198,59,-810,-305,19.8,1547.5,13,5,1,7,5,11,1,1,0,0,16285,7.0,18450,212,52,810,305,21.2,1628.5
4527544639,0,50,1,0,8,9,8,0,0,0,0,15372,6.8,16833,161,40,-3616,-3352,16.1,1537.2,12,2,1,9,8,4,1,1,0,0,18988,7.6,20185,248,64,3616,3352,24.8,1898.8
4514844404,0,15,4,0,7,9,8,0,0,0,0,16795,6.8,18170,217,52,-1317,-816,21.7,1679.5,17,1,1,9,7,14,1,1,0,0,18112,7.4,18986,247,51,1317,816,24.7,1811.2
4494926014,0,16,1,0,3,8,3,0,0,0,0,14397,6.6,16267,210,52,-3517,-3374,21.0,1439.7,14,2,1,8,3,9,1,1,0,0,17914,7.2,19641,226,64,3517,3374,22.6,1791.4
4470712101,0,22,3,0,7,4,8,1,1,0,0,16413,6.8,16989,209,39,188,-1124,20.9,1641.3,83,6,1,4,7,6,0,0,0,0,16225,6.8,18113,248,47,-188,1124,24.8,1622.5
4524260824,0,14,1,1,7,7,6,0,0,0,0,16346,7.0,18557,209,44,-346,-358,20.9,1634.6,33,1,0,7,7,7,0,0,0,0,16692,7.2,18915,182,67,346,358,18.2,1669.2
4526856265,0,14,7,1,8,5,7,0,0,0,0,17113,7.4,18861,245,47,1176,1300,24.5,1711.3,18,4,0,5,8,6,1,1,0,0,15937,7.0,17561,225,52,-1176,-1300,22.5,1593.7
4467944823,0,17,3,1,2,10,0,0,0,0,0,14704,7.0,17930,227,60,-3517,-1818,22.7,1470.4,11,1,0,10,2,7,1,1,0,0,18221,7.6,19748,235,56,3517,1818,23.5,1822.1
4448123749,0,14,1,0,1,11,0,0,0,0,0,13447,6.4,16199,201,51,-5698,-3675,20.1,1344.7,17,4,1,11,1,12,2,1,1,0,19145,7.2,19874,240,44,5698,3675,24.0,1914.5
4520801995,0,17,2,0,2,10,1,0,0,0,0,15239,7.0,18073,232,52,-3449,-1995,23.2,1523.9,17,0,1,10,2,13,1,1,0,0,18688,7.6,20068,231,57,3449,1995,23.1,1868.8
4466034400,0,15,1,1,2,13,2,0,0,0,0,14712,6.2,15826,202,52,-4016,-3206,20.2,1471.2,17,2,0,13,2,17,1,1,0,0,18728,7.0,19032,253,48,4016,3206,25.3,1872.8
4507320032,0,15,0,0,6,10,9,0,0,0,0,15325,6.6,16317,192,36,-2964,-2587,19.2,1532.5,16,1,1,10,6,12,2,1,1,0,18289,7.2,18904,208,56,2964,2587,20.8,1828.9
4413130871,0,15,2,0,3,3,2,1,0,1,0,15885,7.0,18531,243,52,-257,-883,24.3,1588.5,16,1,1,3,3,6,0,0,0,0,16142,7.2,19414,232,76,257,883,23.2,1614.2
4513252060,0,15,2,0,3,4,4,0,0,0,0,15013,6.6,16860,212,56,-741,-637,21.2,1501.3,16,4,1,4,3,7,1,1,0,0,15754,6.8,17497,225,55,741,637,22.5,1575.4
4527750562,0,37,4,1,5,7,6,0,0,0,0,15993,6.8,17528,206,48,-645,-448,20.6,1599.3,19,5,0,7,5,9,1,1,0,0,16638,6.8,17976,197,64,645,448,19.7,1663.8
4486380071,0,11,5,1,7,16,7,0,0,0,0,16711,6.4,15855,201,51,-3289,-4291,20.1,1671.1,15,1,0,16,7,17,1,0,1,0,20000,7.4,20146,201,49,3289,4291,20.1,2000.0
4527044244,0,16,1,0,3,5,2,0,0,0,0,15314,7.0,17971,226,45,-888,1328,22.6,1531.4,15,2,1,5,3,3,1,0,1,0,16202,6.8,16643,220,37,888,-1328,22.0,1620.2
4518127728,0,15,1,1,4,8,3,0,0,0,0,15525,6.6,16079,198,60,-1784,-2938,19.8,1552.5,35,2,0,8,4,7,0,0,0,0,17309,7.0,19017,227,48,1784,2938,22.7,1730.9
4504197539,0,13,2,0,3,5,3,0,0,0,0,15553,7.2,18934,244,55,-1449,-349,24.4,1555.3,41,5,1,5,3,3,0,0,0,0,17002,7.2,19283,250,76,1449,349,25.0,1700.2
4500662035,0,14,4,1,7,2,6,0,0,0,0,16315,7.0,18067,201,60,1167,510,20.1,1631.5,17,2,0,2,7,2,0,0,0,0,15148,6.8,17557,240,59,-1167,-510,24.0,1514.8
4522847421,0,9,3,1,6,9,6,1,1,0,0,17108,6.8,17877,211,59,-1394,-2258,21.1,1710.8,17,1,0,9,6,10,0,0,0,0,18502,7.6,20135,210,67,1394,2258,21.0,1850.2
4457008348,0,18,4,0,3,10,3,0,0,0,0,15130,6.6,16749,220,42,-2528,-1326,22.0,1513.0,52,7,1,10,3,13,0,0,0,0,17658,7.0,18075,218,41,2528,1326,21.8,1765.8
4484049712,0,108,0,1,7,8,7,0,0,0,0,15857,6.6,16404,177,52,-2314,-1903,17.7,1585.7,16,3,0,8,7,8,2,1,1,0,18171,6.8,18307,203,48,2314,1903,20.3,1817.1
4522449879,0,16,3,1,6,7,8,0,0,0,0,16086,7.0,17888,199,48,-756,-831,19.9,1608.6,37,4,0,7,6,8,1,1,0,0,16842,7.2,18719,235,60,756,831,23.5,1684.2
4521841751,0,16,0,0,6,14,9,1,1,0,0,15544,6.2,15313,176,43,-4625,-3447,17.6,1554.4,14,5,1,14,6,17,1,0,1,1,20169,7.2,18760,239,40,4625,3447,23.9,2016.9
4511419534,0,15,4,1,7,7,9,0,0,0,0,16276,6.6,17546,215,40,273,-1195,21.5,1627.6,16,3,0,7,7,2,1,0,1,0,16003,7.2,18741,196,48,-273,1195,19.6,1600.3
4509363217,0,30,5,1,5,7,4,0,0,0,0,15386,6.6,16591,188,44,-1739,-826,18.8,1538.6,21,7,0,7,5,9,1,0,1,0,17125,6.8,17417,222,48,1739,826,22.2,1712.5
4486673822,0,15,3,0,4,7,5,0,0,0,0,15535,6.8,18068,214,56,-1608,-572,21.4,1553.5,16,1,1,7,4,9,2,1,1,0,17143,7.0,18640,220,59,1608,572,22.0,1714.3
4491049455,0,16,4,0,5,11,6,0,0,0,0,15424,6.6,16080,208,45,-3692,-3112,20.8,1542.4,14,4,1,11,5,16,2,1,1,0,19116,7.2,19192,195,55,3692,3112,19.5,1911.6
4297422468,0,18,2,0,4,6,0,0,0,0,0,14827,6.6,17370,207,55,-2713,-1237,20.7,1482.7,20,6,1,6,4,11,2,1,1,0,17540,7.2,18607,247,56,2713,1237,24.7,1754.0
4486514272,0,17,1,1,7,6,10,0,0,0,0,16360,6.4,16497,218,44,-75,144,21.8,1636.0,14,2,0,6,7,8,0,0,0,0,16435,6.8,16353,207,40,75,-144,20.7,1643.5
4508915149,0,14,1,0,0,5,0,0,0,0,0,13561,6.6,16518,220,51,-1958,-1775,22.0,1356.1,15,3,1,5,0,4,1,1,0,0,15519,7.0,18293,223,37,1958,1775,22.3,1551.9
4526932906,0,21,3,1,5,9,6,0,0,0,0,16462,7.0,17215,223,52,-922,-1305,22.3,1646.2,12,2,0,9,5,11,2,1,1,0,17384,7.2,18520,227,49,922,1305,22.7,1738.4
4495708706,0,18,2,1,3,10,4,0,0,0,0,14557,6.4,15128,200,48,-3582,-5395,20.0,1455.7,16,0,0,10,3,10,2,1,1,0,18139,7.6,20523,246,63,3582,5395,24.6,1813.9
4505265174,0,21,4,0,5,7,7,1,1,0,0,15983,7.2,18335,229,43,-704,-531,22.9,1598.3,18,3,1,7,5,10,0,0,0,0,16687,7.2,18866,205,48,704,531,20.5,1668.7
4494122162,0,12,1,1,3,6,2,0,0,0,0,14607,6.8,17527,204,56,-2968,-2262,20.4,1460.7,40,2,0,6,3,8,2,1,1,0,17575,7.6,19789,243,56,2968,2262,24.3,1757.5
4509977321,0,12,4,0,2,5,1,0,0,0,0,14349,7.0,17864,199,62,-2289,-277,19.9,1434.9,20,1,1,5,2,4,1,1,0,0,16638,7.2,18141,246,57,2289,277,24.6,1663.8
4526239268,0,9,0,0,2,11,4,1,1,0,0,14079,6.6,16131,215,51,-4780,-3425,21.5,1407.9,15,3,1,11,2,13,0,0,0,0,18859,7.4,19556,214,52,4780,3425,21.4,1885.9
4483846553,0,11,3,0,4,4,5,0,0,0,0,14782,6.8,16617,211,47,-1430,-2438,21.1,1478.2,38,1,1,4,4,3,2,1,1,0,16212,7.2,19055,236,64,1430,2438,23.6,1621.2
4449428423,0,19,6,1,3,7,5,1,1,0,0,14758,6.6,15950,202,52,-2993,-2494,20.2,1475.8,16,4,0,7,3,12,1,0,1,1,17751,7.0,18444,215,39,2993,2494,21.5,1775.1
4466458124,0,14,2,0,2,6,2,1,1,0,0,13590,6.6,15723,170,56,-3089,-1857,17.0,1359.0,18,1,1,6,2,6,0,0,0,0,16679,6.8,17580,215,47,3089,1857,21.5,1667.9
4511790029,0,15,4,0,5,10,7,0,0,0,0,15381,6.4,16749,202,51,-2099,-1505,20.2,1538.1,19,4,1,10,5,15,1,1,0,0,17480,7.0,18254,206,52,2099,1505,20.6,1748.0
4523557396,0,20,1,1,8,8,11,0,0,0,0,16922,7.0,17511,191,44,118,-532,19.1,1692.2,17,6,0,8,8,12,1,1,0,0,16804,7.0,18043,193,62,-118,532,19.3,1680.4
4496613107,0,19,5,1,4,5,7,0,0,0,0,16254,7.2,18913,248,60,-329,-230,24.8,1625.4,14,6,0,5,4,5,0,0,0,0,16583,7.2,19143,272,47,329,230,27.2,1658.3
4524902053,0,13,1,1,2,6,4,0,0,0,0,14796,6.4,16514,225,50,-2944,-2835,22.5,1479.6,16,0,0,6,2,7,1,1,0,0,17740,7.2,19349,231,49,2944,2835,23.1,1774.0
4506495968,0,8,2,0,7,11,6,1,0,1,0,16998,6.6,17282,207,55,-1343,-591,20.7,1699.8,18,3,1,11,7,15,1,1,0,0,18341,6.8,17873,191,40,1343,591,19.1,1834.1
4523459818,0,16,5,1,3,5,2,1,1,0,0,14098,6.2,14987,198,49,-2511,-2288,19.8,1409.8,20,1,0,5,3,6,0,0,0,0,16609,6.8,17275,216,40,2511,2288,21.6,1660.9
4527458962,0,15,5,0,9,9,8,0,0,0,0,16526,6.6,17292,194,41,-609,-1011,19.4,1652.6,19,5,1,9,9,10,0,0,0,0,17135,7.0,18303,228,36,609,1011,22.8,1713.5
4493753133,0,15,1,0,7,7,10,0,0,0,0,16095,6.8,17497,228,24,-986,-1163,22.8,1609.5,36,2,1,7,7,6,0,0,0,0,17081,7.2,18660,237,46,986,1163,23.7,1708.1
4474824262,0,29,0,1,5,4,4,0,0,0,0,15730,6.6,16849,223,49,-384,-1408,22.3,1573.0,10,1,0,4,5,3,1,1,0,0,16114,7.0,18257,220,61,384,1408,22.0,1611.4
4503318833,0,12,2,0,4,8,4,0,0,0,0,15715,6.8,17533,229,40,-2733,-2104,22.9,1571.5,16,3,1,8,4,9,2,1,1,0,18448,7.4,19637,237,56,2733,2104,23.7,1844.8
4489371310,0,12,0,0,1,6,0,0,0,0,0,13977,6.6,17736,208,60,-4097,-1658,20.8,1397.7,31,1,1,6,1,7,0,0,0,0,18074,7.2,19394,226,72,4097,1658,22.6,1807.4
4519099479,0,16,2,0,7,6,8,0,0,0,0,16286,7.0,17910,223,40,369,561,22.3,1628.6,15,1,1,6,7,8,0,0,0,0,15917,7.0,17349,196,52,-369,-561,19.6,1591.7
4520814737,0,15,3,0,4,3,4,1,0,1,0,16043,7.0,18432,237,48,711,1614,23.7,1604.3,13,2,1,3,4,5,1,1,0,0,15332,6.8,16818,209,48,-711,-1614,20.9,1533.2
4526480699,0,8,3,1,6,5,7,1,0,1,0,15964,6.8,18133,217,51,-68,963,21.7,1596.4,55,1,0,5,6,9,1,1,0,0,16032,6.8,17170,198,51,68,-963,19.8,1603.2
4519133834,0,16,2,0,6,16,6,1,1,0,0,14999,6.4,15530,192,44,-6027,-3955,19.2,1499.9,18,4,1,16,6,24,0,0,0,0,21026,7.4,19485,228,52,6027,3955,22.8,2102.6
4484797457,0,18,8,0,6,11,9,0,0,0,0,16124,7.0,17595,232,37,-2494,-1188,23.2,1612.4,20,5,1,11,6,18,1,1,0,0,18618,7.0,18783,230,50,2494,1188,23.0,1861.8
4493134423,0,32,3,1,6,9,4,0,0,0,0,16672,7.0,18758,231,52,-1112,311,23.1,1667.2,16,0,0,9,6,8,0,0,0,0,17784,6.8,18447,211,36,1112,-311,21.1,1778.4
4505453773,0,44,4,0,5,12,6,0,0,0,0,15851,6.6,16800,182,56,-3248,-2442,18.2,1585.1,19,0,1,12,5,9,1,1,0,0,19099,7.2,19242,243,44,3248,2442,24.3,1909.9
4474736524,0,17,2,0,3,9,2,0,0,0,0,14660,6.6,17265,203,45,-3251,-2143,20.3,1466.0,13,4,1,9,3,5,1,1,0,0,17911,7.2,19408,234,52,3251,2143,23.4,1791.1
4457517479,0,15,3,0,4,8,6,0,0,0,0,15431,6.8,17309,218,47,-2661,-3190,21.8,1543.1,106,5,1,8,4,9,2,1,1,0,18092,7.2,20499,260,63,2661,3190,26.0,1809.2
4500426573,0,17,3,0,3,8,3,0,0,0,0,15015,6.8,17386,216,60,-2327,-2301,21.6,1501.5,75,3,1,8,3,8,1,0,1,0,17342,7.2,19687,230,52,2327,2301,23.0,1734.2
4437082520,0,16,4,1,10,6,11,1,1,0,0,17538,7.0,19111,219,48,34,145,21.9,1753.8,16,2,0,6,10,6,0,0,0,0,17504,7.2,18966,225,68,-34,-145,22.5,1750.4
4499840707,0,16,3,0,4,4,4,1,1,0,0,15977,6.8,17115,224,56,1033,1209,22.4,1597.7,81,4,1,4,4,3,0,0,0,0,14944,6.4,15906,185,52,-1033,-1209,18.5,1494.4
4511072996,0,13,1,1,8,10,14,1,1,0,0,17275,6.8,16684,204,55,-604,-1254,20.4,1727.5,37,5,0,10,8,16,0,0,0,0,17879,7.0,17938,186,52,604,1254,18.6,1787.9
4524922890,0,43,3,0,5,12,7,0,0,0,0,15893,6.8,17285,202,35,-3909,-1904,20.2,1589.3,17,5,1,12,5,13,1,0,1,0,19802,7.2,19189,228,35,3909,1904,22.8,1980.2
4516068485,0,37,4,0,0,10,0,0,0,0,0,12837,6.2,15086,196,36,-5369,-5193,19.6,1283.7,20,3,1,10,0,10,2,1,1,0,18206,7.2,20279,242,47,5369,5193,24.2,1820.6
4502349733,0,18,3,0,1,2,1,0,0,0,0,13449,6.6,16803,189,48,-1641,-500,18.9,1344.9,14,2,1,2,1,4,0,0,0,0,15090,7.0,17303,224,52,1641,500,22.4,1509.0
4457538787,0,19,1,0,2,1,3,1,1,0,0,14494,6.8,18008,244,47,-618,-413,24.4,1449.4,38,4,1,1,2,2,0,0,0,0,15112,6.8,18421,247,60,618,413,24.7,1511.2
4521949679,0,14,2,1,6,7,8,1,1,0,0,15307,6.4,15025,175,48,-660,-922,17.5,1530.7,44,1,0,7,6,12,0,0,0,0,15967,6.4,15947,171,37,660,922,17.1,1596.7
4524601777,0,16,4,1,6,5,13,0,0,0,0,15859,6.8,16551,209,44,-947,-2043,20.9,1585.9,24,4,0,5,6,6,0,0,0,0,16806,6.8,18594,218,61,947,2043,21.8,1680.6
4522484818,0,16,2,1,8,8,8,0,0,0,0,17698,7.2,18605,218,56,-373,-1526,21.8,1769.8,14,2,0,8,8,5,1,1,0,0,18071,7.4,20131,233,76,373,1526,23.3,1807.1
4519250441,0,16,3,0,1,12,0,1,0,1,0,13981,6.6,16277,220,52,-5870,-3642,22.0,1398.1,41,4,1,12,1,18,0,0,0,0,19851,7.4,19919,234,53,5870,3642,23.4,1985.1
4512891978,0,13,1,1,6,4,8,1,1,0,0,15452,7.0,18378,191,49,-1039,827,19.1,1545.2,12,6,0,4,6,4,1,0,1,1,16491,6.8,17551,215,51,1039,-827,21.5,1649.1
4454573791,0,20,7,1,4,8,7,1,0,1,0,15228,6.8,16963,198,52,-2236,-2070,19.8,1522.8,20,5,0,8,4,8,1,1,0,0,17464,7.2,19033,227,48,2236,2070,22.7,1746.4
4520942690,0,14,4,0,6,6,6,0,0,0,0,16158,7.0,17652,240,32,197,1241,24.0,1615.8,20,4,1,6,6,10,0,0,0,0,15961,6.6,16411,205,52,-197,-1241,20.5,1596.1
4515338624,0,13,1,0,5,11,8,0,0,0,0,15979,6.8,16648,190,39,-3456,-1429,19.0,1597.9,15,1,1,11,5,15,2,1,1,0,19435,7.0,18077,189,44,3456,1429,18.9,1943.5
4465302034,0,18,5,0,7,13,6,0,0,0,0,16851,6.8,17624,215,52,-2174,-117,21.5,1685.1,17,3,1,13,7,17,0,0,0,0,19025,7.0,17741,211,52,2174,117,21.1,1902.5
4519445793,0,20,4,1,5,6,2,2,1,1,0,15304,6.6,17175,195,44,-1469,116,19.5,1530.4,17,3,0,6,5,8,0,0,0,0,16773,6.8,17059,238,46,1469,-116,23.8,1677.3
4473666102,0,13,3,0,1,10,1,0,0,0,0,13785,6.8,16211,215,43,-4124,-3090,21.5,1378.5,16,3,1,10,1,13,1,1,0,0,17909,7.2,19301,260,54,4124,3090,26.0,1790.9
4526803305,0,54,2,0,3,4,6,0,0,0,0,14725,6.8,17291,204,43,-1680,-1155,20.4,1472.5,21,3,1,4,3,3,2,1,1,0,16405,7.4,18446,258,56,1680,1155,25.8,1640.5
4510668822,0,13,1,0,6,9,8,0,0,0,0,15087,6.6,17017,177,43,-3782,-3060,17.7,1508.7,14,1,1,9,6,10,1,1,0,0,18869,7.4,20077,245,65,3782,3060,24.5,1886.9
4511547876,0,13,9,0,3,4,4,1,1,0,0,14017,6.2,15335,185,48,-2309,-2673,18.5,1401.7,35,1,1,4,3,5,0,0,0,0,16326,7.2,18008,214,63,2309,2673,21.4,1632.6
4515536584,0,16,3,1,4,4,4,1,0,1,0,15420,6.6,16188,185,61,-634,-1526,18.5,1542.0,21,3,0,4,4,4,1,1,0,0,16054,6.8,17714,236,52,634,1526,23.6,1605.4
4524181297,0,14,4,1,11,6,17,0,0,0,0,18212,7.0,18286,201,47,1924,1938,20.1,1821.2,14,3,0,6,11,5,0,0,0,0,16288,6.6,16348,212,52,-1924,-1938,21.2,1628.8
4523429650,0,14,2,1,6,7,8,0,0,0,0,17318,7.0,18742,237,72,568,-205,23.7,1731.8,18,1,0,7,6,8,2,1,1,0,16750,7.4,18947,202,60,-568,205,20.2,1675.0
4516376461,0,9,1,0,0,9,0,0,0,0,0,12756,6.4,16250,190,54,-4949,-4010,19.0,1275.6,15,2,1,9,0,7,2,1,1,0,17705,7.4,20260,253,52,4949,4010,25.3,1770.5
4504019656,0,11,5,1,9,7,5,0,0,0,0,16880,7.0,17998,195,39,-296,872,19.5,1688.0,49,3,0,7,9,7,0,0,0,0,17176,6.8,17126,246,28,296,-872,24.6,1717.6
4463008615,0,24,2,1,3,2,3,0,0,0,0,14804,7.0,17782,223,52,258,-298,22.3,1480.4,82,1,0,2,3,3,1,1,0,0,14546,7.0,18080,200,60,-258,298,20.0,1454.6
4444198769,0,15,1,1,8,6,18,0,0,0,0,17008,6.8,16636,206,40,801,-1533,20.6,1700.8,14,1,0,6,8,6,0,0,0,0,16207,7.0,18169,223,48,-801,1533,22.3,1620.7
4518870146,0,13,2,0,1,7,2,0,0,0,0,14490,7.0,17638,222,60,-2987,-2017,22.2,1449.0,14,4,1,7,1,10,1,1,0,0,17477,7.4,19655,235,56,2987,2017,23.5,1747.7
4515307399,0,18,1,1,5,8,5,0,0,0,0,16659,7.0,17777,234,60,-1003,-899,23.4,1665.9,15,1,0,8,5,7,2,1,1,0,17662,7.0,18676,217,59,1003,899,21.7,1766.2
4443526032,0,35,4,0,4,7,6,0,0,0,0,15902,6.8,17995,241,48,-1190,-66,24.1,1590.2,27,6,1,7,4,14,1,1,0,0,17092,6.8,18061,241,57,1190,66,24.1,1709.2
4524863981,0,19,2,0,4,11,3,0,0,0,0,15107,6.6,16753,200,41,-3799,-3285,20.0,1510.7,10,4,1,11,4,10,1,1,0,0,18906,7.2,20038,226,45,3799,3285,22.6,1890.6
4468243911,0,13,0,1,6,7,2,0,0,0,0,16190,6.8,18041,234,54,-158,-67,23.4,1619.0,16,0,0,7,6,13,1,1,0,0,16348,7.0,18108,217,51,158,67,21.7,1634.8
4477261749,0,15,4,0,1,4,1,2,1,1,0,14142,6.8,16922,229,52,-1691,-1608,22.9,1414.2,25,1,1,4,1,4,0,0,0,0,15833,7.0,18530,234,59,1691,1608,23.4,1583.3
4517892829,0,8,3,0,2,4,1,0,0,0,0,14856,6.8,18155,240,51,-1129,-1348,24.0,1485.6,34,0,1,4,2,4,1,1,0,0,15985,7.4,19503,225,51,1129,1348,22.5,1598.5
4492023139,0,16,3,1,4,8,1,0,0,0,0,15135,6.6,17280,240,54,-1634,-1916,24.0,1513.5,14,5,0,8,4,7,0,0,0,0,16769,7.4,19196,220,54,1634,1916,22.0,1676.9
4510868167,0,142,4,0,1,8,0,1,1,0,0,13631,6.6,16334,220,48,-3839,-3318,22.0,1363.1,39,2,1,8,1,7,1,0,1,0,17470,7.4,19652,233,55,3839,3318,23.3,1747.0
4493326882,0,103,6,0,6,10,5,1,1,0,1,16878,7.0,17994,185,64,-2636,-1390,18.5,1687.8,15,6,1,10,6,9,1,0,1,1,19514,7.4,19384,227,55,2636,1390,22.7,1951.4
4455545387,0,14,1,0,3,11,4,0,0,0,0,14341,6.6,16688,184,64,-5295,-3863,18.4,1434.1,18,3,1,11,3,10,1,1,0,0,19636,7.6,20551,260,64,5295,3863,26.0,1963.6
4527165791,0,17,8,1,8,8,12,0,0,0,0,16291,6.4,16508,180,33,-870,-1348,18.0,1629.1,34,5,0,8,8,11,1,1,0,0,17161,7.0,17856,207,46,870,1348,20.7,1716.1
4524924257,0,14,3,0,4,9,1,1,0,1,0,14979,6.6,17213,210,52,-3414,-1141,21.0,1497.9,20,3,1,9,4,11,0,0,0,0,18393,7.2,18354,229,51,3414,1141,22.9,1839.3
4526993807,0,15,2,1,8,6,14,0,0,0,0,15724,6.2,15396,203,28,-866,-2133,20.3,1572.4,23,1,0,6,8,5,1,0,1,0,16590,7.0,17529,198,51,866,2133,19.8,1659.0
4515621267,0,73,4,0,3,9,4,0,0,0,0,14282,6.6,16446,182,49,-4690,-3429,18.2,1428.2,15,8,1,9,3,11,1,1,0,0,18972,7.4,19875,235,65,4690,3429,23.5,1897.2
4470053265,0,15,2,0,0,3,0,0,0,0,0,14183,6.8,17942,243,64,-975,334,24.3,1418.3,15,2,1,3,0,5,1,1,0,0,15158,7.0,17608,206,48,975,-334,20.6,1515.8
4523809434,0,76,6,0,5,5,4,1,1,0,0,16203,7.0,18321,228,51,2,-365,22.8,1620.3,19,5,1,5,5,6,0,0,0,0,16201,7.0,18686,228,53,-2,365,22.8,1620.1
4490764979,0,31,5,1,4,3,3,1,1,0,0,15876,7.0,18504,228,63,525,294,22.8,1587.6,22,3,0,3,4,2,0,0,0,0,15351,6.8,18210,227,48,-525,-294,22.7,1535.1
4508246222,0,18,2,1,4,4,3,0,0,0,0,15601,6.8,17171,232,48,415,14,23.2,1560.1,14,4,0,4,4,5,1,1,0,0,15186,6.8,17157,202,70,-415,-14,20.2,1518.6
4502159358,0,15,2,1,13,9,19,1,1,0,0,19528,7.2,18855,211,42,1852,219,21.1,1952.8,16,2,0,9,13,5,0,0,0,0,17676,7.2,18636,217,72,-1852,-219,21.7,1767.6
4524787286,0,99,5,0,7,10,11,0,0,0,0,16332,6.8,17067,196,56,-1514,-893,19.6,1633.2,15,4,1,10,7,9,1,1,0,0,17846,6.8,17960,211,48,1514,893,21.1,1784.6
4513554113,0,16,2,0,0,7,0,0,0,0,0,12774,6.6,15643,199,44,-4538,-2876,19.9,1277.4,23,3,1,7,0,13,1,1,0,0,17312,6.8,18519,250,57,4538,2876,25.0,1731.2
4522574543,0,19,4,0,11,7,15,1,1,0,0,20007,7.0,19097,241,60,3774,4377,24.1,2000.7,13,4,1,7,11,9,0,0,0,0,16233,6.0,14720,184,28,-3774,-4377,18.4,1623.3
4410060427,0,17,4,1,5,5,5,1,0,1,0,16574,7.2,19529,235,60,803,857,23.5,1657.4,18,4,0,5,5,6,1,1,0,0,15771,7.2,18672,204,64,-803,-857,20.4,1577.1
4524910590,0,12,2,0,5,8,7,0,0,0,0,15513,6.6,17308,203,43,-1791,507,20.3,1551.3,11,0,1,8,5,14,2,1,1,0,17304,6.8,16801,225,41,1791,-507,22.5,1730.4
4465188797,0,14,1,1,6,7,5,0,0,0,0,15891,7.0,17964,207,41,-1190,-911,20.7,1589.1,14,1,0,7,6,4,0,0,0,0,17081,7.0,18875,224,54,1190,911,22.4,1708.1
4527061275,0,14,2,0,5,8,4,0,0,0,0,15921,6.8,17466,203,40,-1110,-721,20.3,1592.1,14,2,1,8,5,6,0,0,0,0,17031,7.2,18187,215,49,1110,721,21.5,1703.1
4521814295,0,14,6,0,7,4,7,1,0,1,0,16806,6.8,17149,217,50,1904,892,21.7,1680.6,38,6,1,4,7,4,0,0,0,0,14902,6.4,16257,200,55,-1904,-892,20.0,1490.2
4515416526,0,20,5,0,2,4,1,0,0,0,0,14790,7.2,18109,240,58,-1156,466,24.0,1479.0,17,5,1,4,2,5,1,1,0,0,15946,6.8,17643,240,48,1156,-466,24.0,1594.6
4526408349,0,17,4,1,4,5,4,2,1,1,0,16552,7.2,18731,227,57,334,145,22.7,1655.2,16,3,0,5,4,9,0,0,0,0,16218,6.8,18586,225,56,-334,-145,22.5,1621.8
4481839538,0,12,1,1,6,9,5,1,1,0,0,16388,6.8,17753,213,40,-1436,-1406,21.3,1638.8,19,0,0,9,6,8,0,0,0,0,17824,7.2,19159,220,52,1436,1406,22.0,1782.4
4445248435,0,32,3,0,5,8,3,1,1,0,0,14795,6.6,16454,178,52,-2914,-2683,17.8,1479.5,19,3,1,8,5,11,1,0,1,0,17709,7.2,19137,229,52,2914,2683,22.9,1770.9
4483500225,0,15,4,0,4,4,2,0,0,0,0,15023,6.8,17293,226,44,-814,-374,22.6,1502.3,17,2,1,4,4,4,1,0,1,0,15837,6.8,17667,232,47,814,374,23.2,1583.7
4524853879,0,12,5,1,5,6,8,1,1,0,0,15999,6.6,17033,234,44,-415,-498,23.4,1599.9,16,1,0,6,5,8,0,0,0,0,16414,7.0,17531,226,48,415,498,22.6,1641.4
4494830005,0,22,5,0,2,2,1,1,1,0,0,14569,6.6,16559,227,38,-676,-864,22.7,1456.9,13,12,1,2,2,3,0,0,0,0,15245,6.8,17423,236,46,676,864,23.6,1524.5
4453712057,0,16,4,1,6,6,5,1,0,1,0,17783,7.6,19374,236,72,1498,149,23.6,1778.3,13,3,0,6,6,7,1,1,0,0,16285,7.4,19225,213,61,-1498,-149,21.3,1628.5
4520952475,0,18,2,0,2,7,1,1,0,1,0,13508,6.2,15002,160,56,-3580,-2967,16.0,1350.8,15,4,1,7,2,6,1,1,0,0,17088,6.6,17969,193,75,3580,2967,19.3,1708.8
4470267464,0,10,1,1,3,11,2,0,0,0,0,15059,6.8,17650,200,57,-3606,-1971,20.0,1505.9,12,1,0,11,3,18,1,1,0,0,18665,7.2,19621,208,46,3606,1971,20.8,1866.5
4526478943,0,16,1,0,5,7,6,0,0,0,0,16132,6.8,17519,210,50,-155,-51,21.0,1613.2,21,3,1,7,5,11,0,0,0,0,16287,7.0,17570,191,54,155,51,19.1,1628.7
4518531939,0,16,5,1,2,6,3,0,0,0,0,14874,6.8,16729,232,60,-3131,-1768,23.2,1487.4,17,4,0,6,2,5,2,1,1,1,18005,7.2,18497,221,47,3131,1768,22.1,1800.5
4496821254,0,15,2,1,9,6,9,2,1,1,0,18050,7.4,19654,239,37,1949,214,23.9,1805.0,12,1,0,6,9,2,0,0,0,0,16101,7.0,19440,214,58,-1949,-214,21.4,1610.1
4522266851,0,14,1,0,1,3,2,0,0,0,0,14054,6.6,17175,205,64,-1744,-1555,20.5,1405.4,14,5,1,3,1,3,1,1,0,0,15798,7.0,18730,232,48,1744,1555,23.2,1579.8
4526548398,0,15,3,1,5,4,9,0,0,0,0,15633,6.8,17562,222,44,148,-543,22.2,1563.3,17,3,0,4,5,4,0,0,0,0,15485,7.0,18105,210,56,-148,543,21.0,1548.5
4508680387,0,14,3,0,9,9,10,1,1,0,0,17326,6.8,17581,188,50,54,-321,18.8,1732.6,85,0,1,9,9,8,0,0,0,0,17272,6.8,17902,193,44,-54,321,19.3,1727.2
4512775669,0,13,2,1,5,2,5,1,1,0,0,15767,7.0,17413,224,52,384,-690,22.4,1576.7,16,3,0,2,5,3,1,0,1,0,15383,7.0,18103,250,48,-384,690,25.0,1538.3
4448445178,0,18,3,0,4,10,3,0,0,0,0,15341,6.8,17802,204,44,-2310,-1604,20.4,1534.1,17,3,1,10,4,11,1,1,0,0,17651,7.2,19406,220,56,2310,1604,22.0,1765.1
4518395320,0,18,6,0,8,9,11,1,0,1,0,17147,6.8,17510,194,48,-1546,-1047,19.4,1714.7,18,6,1,9,8,12,1,1,0,0,18693,6.8,18557,244,55,1546,1047,24.4,1869.3
4515862927,0,17,5,1,5,9,8,1,0,1,0,14927,6.6,16626,194,44,-3214,-2318,19.4,1492.7,19,3,0,9,5,11,1,1,0,0,18141,7.0,18944,239,39,3214,2318,23.9,1814.1
4505644986,0,15,1,1,6,4,8,1,1,0,0,17142,7.2,18300,227,56,576,-1839,22.7,1714.2,15,1,0,4,6,7,1,0,1,0,16566,7.4,20139,222,79,-576,1839,22.2,1656.6
4499810008,0,12,4,0,6,6,10,0,0,0,0,15241,6.6,16491,190,36,-1137,-1402,19.0,1524.1,17,1,1,6,6,6,2,1,1,0,16378,6.8,17893,224,45,1137,1402,22.4,1637.8
4458889473,0,59,7,1,7,7,12,1,0,1,0,17543,7.0,17748,195,51,994,-547,19.5,1754.3,37,6,0,7,7,11,1,1,0,0,16549,7.0,18295,215,36,-994,547,21.5,1654.9
4527441922,0,78,4,0,8,5,9,0,0,0,0,16785,6.8,17837,186,48,-860,214,18.6,1678.5,16,3,1,5,8,7,1,1,0,0,17645,6.6,17623,236,56,860,-214,23.6,1764.5
4514425607,0,17,2,0,7,4,4,1,0,1,0,17994,7.2,20156,269,48,3033,3187,26.9,1799.4,15,2,1,4,7,4,1,1,0,0,14961,6.6,16969,206,44,-3033,-3187,20.6,1496.1
4523121371,0,16,2,1,5,13,4,0,0,0,0,14988,6.2,15585,186,40,-3562,-3319,18.6,1498.8,10,3,0,13,5,20,0,0,0,0,18550,7.2,18904,208,52,3562,3319,20.8,1855.0
4457799018,0,10,1,0,5,10,4,0,0,0,0,14750,6.6,15820,185,44,-3688,-4038,18.5,1475.0,76,1,1,10,5,12,2,1,1,0,18438,7.2,19858,189,60,3688,4038,18.9,1843.8
4472433085,0,53,2,0,3,7,3,0,0,0,0,15162,6.8,18046,227,56,-1980,-973,22.7,1516.2,19,4,1,7,3,5,0,0,0,0,17142,7.2,19019,256,56,1980,973,25.6,1714.2
4519853578,0,12,2,0,5,9,3,1,0,1,0,15173,7.0,17165,183,59,-2354,-1337,18.3,1517.3,16,3,1,9,5,7,1,1,0,0,17527,7.0,18502,210,46,2354,1337,21.0,1752.7
4492694457,0,12,1,0,6,10,7,0,0,0,0,16186,6.6,17103,207,35,-2072,-1355,20.7,1618.6,15,1,1,10,6,10,2,1,1,0,18258,7.0,18458,211,51,2072,1355,21.1,1825.8
4481415061,0,10,1,0,6,14,3,0,0,0,0,16142,6.8,16953,198,59,-3109,-1745,19.8,1614.2,13,1,1,14,6,16,2,1,1,0,19251,7.0,18698,201,37,3109,1745,20.1,1925.1
4517922682,0,35,4,0,7,5,10,0,0,0,0,16526,7.2,19072,217,56,-64,239,21.7,1652.6,66,2,1,5,7,4,0,0,0,0,16590,7.0,18833,214,60,64,-239,21.4,1659.0
4521767558,0,149,2,0,7,9,7,0,0,0,0,17166,7.2,18945,224,52,-1561,925,22.4,1716.6,42,3,1,9,7,10,2,1,1,1,18727,7.0,18020,177,47,1561,-925,17.7,1872.7
4525171151,0,14,3,0,4,6,4,1,1,0,0,15433,7.2,18889,218,66,-1629,-287,21.8,1543.3,16,1,1,6,4,4,0,0,0,0,17062,7.4,19176,249,42,1629,287,24.9,1706.2
4516417495,0,82,2,0,5,3,5,0,0,0,0,16851,7.0,18647,225,65,1706,1154,22.5,1685.1,43,4,1,3,5,5,1,1,0,0,15145,7.0,17493,219,54,-1706,-1154,21.9,1514.5
4493982450,0,81,2,0,3,7,3,1,1,0,0,15058,6.8,17113,223,55,-2588,-497,22.3,1505.8,14,0,1,7,3,3,0,0,0,1,17646,6.8,17610,223,44,2588,497,22.3,1764.6
4513183607,0,45,5,1,8,6,11,1,1,0,0,17405,7.0,18074,204,51,1059,-338,20.4,1740.5,10,5,0,6,8,9,0,0,0,0,16346,7.0,18412,221,36,-1059,338,22.1,1634.6
4515483383,0,12,3,0,2,8,1,0,0,0,0,14183,7.0,17123,221,51,-4625,-1753,22.1,1418.3,15,2,1,8,2,12,1,1,0,0,18808,7.0,18876,248,56,4625,1753,24.8,1880.8
4522653633,0,37,1,1,1,3,1,0,0,0,0,14859,6.8,17412,225,51,-520,-1073,22.5,1485.9,10,13,0,3,1,3,1,1,0,0,15379,7.0,18485,228,60,520,1073,22.8,1537.9
4477637530,0,39,0,1,2,9,3,1,0,1,0,14157,6.4,16183,198,48,-3421,-2978,19.8,1415.7,16,3,0,9,2,10,1,1,0,0,17578,7.2,19161,238,48,3421,2978,23.8,1757.8
4482205629,0,18,2,0,6,5,10,0,0,0,0,16111,6.4,16723,219,44,1039,-79,21.9,1611.1,14,3,1,5,6,3,1,1,0,0,15072,6.8,16802,213,48,-1039,79,21.3,1507.2
4523445811,0,15,3,1,6,4,6,0,0,0,0,16513,7.2,18896,241,48,752,1146,24.1,1651.3,15,3,0,4,6,6,1,1,0,0,15761,7.0,17750,216,51,-752,-1146,21.6,1576.1
4521267611,0,12,4,0,10,12,6,1,1,0,0,17391,6.8,18031,202,56,-3064,-537,20.2,1739.1,18,1,1,12,10,11,1,0,1,1,20455,7.2,18568,180,51,3064,537,18.0,2045.5
4472468889,0,17,3,1,8,4,10,1,1,0,0,17836,7.4,19239,235,67,840,145,23.5,1783.6,16,2,0,4,8,3,0,0,0,0,16996,7.0,19094,263,68,-840,-145,26.3,1699.6
4502808348,0,16,3,0,3,15,3,0,0,0,0,15120,6.8,16829,191,56,-5023,-1374,19.1,1512.0,21,1,1,15,3,28,2,1,1,0,20143,7.2,18203,217,44,5023,1374,21.7,2014.3
4526563599,0,12,1,1,2,8,0,0,0,0,0,14021,6.2,15684,200,55,-3792,-3472,20.0,1402.1,17,2,0,8,2,8,1,1,0,0,17813,7.2,19156,236,43,3792,3472,23.6,1781.3
4513334307,0,12,0,0,1,6,0,0,0,0,0,14748,6.8,17867,212,61,-2619,-1215,21.2,1474.8,45,0,1,6,1,8,1,1,0,0,17367,7.2,19082,237,65,2619,1215,23.7,1736.7
4522616210,0,19,0,0,5,3,5,1,0,1,0,15486,7.0,17388,205,52,904,195,20.5,1548.6,18,2,1,3,5,3,1,1,0,0,14582,6.8,17193,216,44,-904,-195,21.6,1458.2
4486764809,0,16,4,0,1,3,1,1,0,1,0,14605,7.0,17830,244,48,-280,903,24.4,1460.5,14,3,1,3,1,3,1,1,0,0,14885,6.6,16927,217,60,280,-903,21.7,1488.5
4452471591,0,22,3,1,12,3,11,1,1,0,0,18428,7.0,18214,218,47,3117,1745,21.8,1842.8,39,6,0,3,12,4,0,0,0,0,15311,6.6,16469,254,28,-3117,-1745,25.4,1531.1
4513383518,0,53,2,0,0,3,0,1,1,0,0,13787,6.8,17848,225,52,-2153,-1344,22.5,1378.7,14,4,1,3,0,3,0,0,0,0,15940,7.2,19192,237,56,2153,1344,23.7,1594.0
4519148589,0,105,5,1,8,6,13,1,1,0,0,17474,6.8,17436,217,53,1320,-413,21.7,1747.4,65,3,0,6,8,11,0,0,0,0,16154,6.8,17849,223,40,-1320,413,22.3,1615.4
4519991691,0,61,0,1,3,13,4,0,0,0,0,13908,5.4,12798,167,38,-4561,-5031,16.7,1390.8,16,2,0,13,3,20,1,1,0,0,18469,7.0,17829,187,58,4561,5031,18.7,1846.9
4415547977,0,16,6,0,6,8,4,0,0,0,0,15342,6.6,15988,221,39,-1758,-2010,22.1,1534.2,20,3,1,8,6,10,1,1,0,0,17100,7.0,17998,226,48,1758,2010,22.6,1710.0
4410686846,0,17,4,0,3,12,1,0,0,0,0,13800,6.4,15275,165,44,-4921,-2826,16.5,1380.0,17,3,1,12,3,16,1,1,0,0,18721,7.0,18101,208,60,4921,2826,20.8,1872.1
4510156433,0,15,3,0,9,7,10,0,0,0,0,17082,7.2,18101,223,36,188,-498,22.3,1708.2,15,1,1,7,9,11,1,1,0,0,16894,7.0,18599,215,72,-188,498,21.5,1689.4
4512376408,0,11,3,1,8,4,8,1,1,0,0,18385,7.2,19050,244,57,2957,1677,24.4,1838.5,13,4,0,4,8,6,0,0,0,0,15428,6.8,17373,210,46,-2957,-1677,21.0,1542.8
4462377853,0,123,2,1,6,6,6,0,0,0,0,16378,6.8,17819,211,43,428,-558,21.1,1637.8,58,0,0,6,6,6,2,1,1,0,15950,7.0,18377,216,49,-428,558,21.6,1595.0
4503699941,0,18,1,1,8,7,11,1,1,0,0,16465,6.6,17106,215,28,84,-1185,21.5,1646.5,18,3,0,7,8,5,0,0,0,0,16381,7.2,18291,203,51,-84,1185,20.3,1638.1
4521180315,0,17,0,1,5,6,3,1,0,1,0,15048,6.6,16313,209,47,-2099,-2717,20.9,1504.8,18,0,0,6,5,6,1,1,0,0,17147,7.4,19030,239,55,2099,2717,23.9,1714.7
4481379221,0,14,3,1,8,8,9,0,0,0,0,17202,6.6,17447,214,40,-336,-1059,21.4,1720.2,14,0,0,8,8,9,1,1,0,0,17538,7.0,18506,214,71,336,1059,21.4,1753.8
4525226479,0,14,7,1,7,10,11,0,0,0,0,17297,7.0,18422,228,51,-2526,-1811,22.8,1729.7,17,3,0,10,7,11,2,1,1,1,19823,7.4,20233,221,47,2526,1811,22.1,1982.3
4524141985,0,18,2,0,2,3,3,0,0,0,0,14510,6.8,17801,247,36,-1456,-251,24.7,1451.0,79,3,1,3,2,5,2,1,1,0,15966,7.0,18052,252,56,1456,251,25.2,1596.6
4472496029,0,15,2,1,6,6,5,1,1,0,0,15414,6.4,16960,188,43,-2545,-761,18.8,1541.4,17,2,0,6,6,5,1,0,1,1,17959,6.8,17721,225,51,2545,761,22.5,1795.9
4500668371,0,14,2,0,2,9,3,0,0,0,0,14433,6.4,15908,210,42,-4395,-4086,21.0,1443.3,17,4,1,9,2,9,2,1,1,1,18828,7.4,19994,219,63,4395,4086,21.9,1882.8
4507561885,0,17,5,0,1,5,2,0,0,0,0,14297,6.6,16721,235,54,-2955,-3054,23.5,1429.7,59,2,1,5,1,4,1,1,0,0,17252,7.2,19775,257,68,2955,3054,25.7,1725.2
4384388180,0,16,2,0,6,5,6,0,0,0,0,15691,7.0,17592,212,48,456,-69,21.2,1569.1,13,1,1,5,6,3,2,1,1,0,15235,6.8,17661,192,52,-456,69,19.2,1523.5
4523501423,0,81,0,0,6,12,6,0,0,0,0,16020,6.8,17180,215,39,-2618,-2637,21.5,1602.0,15,3,1,12,6,7,0,0,0,0,18638,7.6,19817,212,52,2618,2637,21.2,1863.8
4427951118,0,16,3,0,4,11,5,1,0,1,0,15372,6.8,17002,213,57,-2585,204,21.3,1537.2,18,2,1,11,4,12,1,1,0,0,17957,6.8,16798,209,40,2585,-204,20.9,1795.7
4458785938,0,12,1,0,3,9,3,0,0,0,0,14851,6.6,16367,183,66,-3151,-3729,18.3,1485.1,15,1,1,9,3,9,0,0,0,0,18002,7.4,20096,207,46,3151,3729,20.7,1800.2
4516306111,0,15,2,0,2,5,0,0,0,0,0,15080,6.8,17979,262,56,-1267,427,26.2,1508.0,13,5,1,5,2,6,2,1,1,0,16347,7.0,17552,255,48,1267,-427,25.5,1634.7
4450464581,0,17,7,1,6,9,7,0,0,0,0,16035,6.6,17041,196,52,-2257,-2894,19.6,1603.5,40,3,0,9,6,5,1,1,0,0,18292,7.4,19935,230,52,2257,2894,23.0,1829.2
4459701274,0,18,3,0,1,5,1,1,1,0,0,15364,7.0,18462,233,72,-673,-48,23.3,1536.4,12,3,1,5,1,6,0,0,0,0,16037,7.0,18510,206,48,673,48,20.6,1603.7
4510149205,0,15,1,1,7,6,10,0,0,0,0,15889,7.0,18326,228,32,-1253,17,22.8,1588.9,16,3,0,6,7,7,0,0,0,0,17142,7.0,18309,225,44,1253,-17,22.5,1714.2
4465798223,0,18,1,0,5,8,6,0,0,0,0,15958,6.6,16741,233,44,-84,-22,23.3,1595.8,37,4,1,8,5,9,0,0,0,0,16042,6.6,16763,190,36,84,22,19.0,1604.2
4486701879,0,37,2,0,8,8,15,1,1,0,0,17192,7.0,17774,190,59,203,557,19.0,1719.2,21,3,1,8,8,14,0,0,0,0,16989,6.8,17217,235,44,-203,-557,23.5,1698.9
4523038174,0,14,1,1,2,12,3,0,0,0,0,13126,6.0,14222,175,46,-4394,-3817,17.5,1312.6,12,4,0,12,2,11,1,1,0,0,17520,7.0,18039,195,44,4394,3817,19.5,1752.0
4519467350,0,14,1,0,6,7,10,2,1,1,0,15931,7.0,17903,202,48,-1613,-836,20.2,1593.1,17,1,1,7,6,10,0,0,0,0,17544,7.2,18739,217,58,1613,836,21.7,1754.4
4451654412,0,14,4,0,1,12,1,0,0,0,0,13453,6.4,15565,215,40,-5403,-4604,21.5,1345.3,25,0,1,12,1,17,1,1,0,0,18856,7.4,20169,232,50,5403,4604,23.2,1885.6
4464386796,0,14,1,0,5,10,2,1,0,1,0,15974,6.8,18618,226,60,-2545,-1541,22.6,1597.4,13,4,1,10,5,9,1,1,0,0,18519,7.6,20159,247,56,2545,1541,24.7,1851.9
4469156590,0,14,0,1,8,13,8,1,1,0,0,16797,6.8,17770,200,48,-3201,-3067,20.0,1679.7,55,1,0,13,8,16,0,0,0,0,19998,7.6,20837,232,47,3201,3067,23.2,1999.8
4521179969,0,16,1,0,9,12,13,0,0,0,0,17867,6.6,17671,218,49,-1354,-798,21.8,1786.7,15,6,1,12,9,23,0,0,0,0,19221,7.2,18469,214,42,1354,798,21.4,1922.1
4447263506,0,16,1,1,5,1,0,1,1,0,0,16117,7.2,19109,221,60,2975,3977,22.1,1611.7,13,2,0,1,5,1,0,0,0,0,13142,6.2,15132,182,42,-2975,-3977,18.2,1314.2
4520540125,0,38,4,0,5,7,6,0,0,0,0,15485,6.8,17345,208,42,-1397,-730,20.8,1548.5,18,2,1,7,5,5,1,1,0,0,16882,7.2,18075,225,70,1397,730,22.5,1688.2
4498640810,0,18,2,0,3,5,4,0,0,0,0,14827,7.0,17341,201,41,-1838,-1584,20.1,1482.7,37,2,1,5,3,4,1,1,0,0,16665,7.0,18925,230,67,1838,1584,23.0,1666.5
4500004334,0,18,1,0,4,6,3,1,1,0,0,15377,7.2,18315,215,51,-1262,614,21.5,1537.7,13,2,1,6,4,5,0,0,0,0,16639,7.0,17701,225,66,1262,-614,22.5,1663.9
4527648336,0,38,6,1,9,5,7,0,0,0,0,16940,7.2,18098,203,36,893,256,20.3,1694.0,19,16,0,5,9,5,1,1,0,0,16047,7.0,17842,228,48,-893,-256,22.8,1604.7
4515342785,0,15,2,1,6,5,4,1,1,0,0,15698,7.0,17468,206,59,-1143,-859,20.6,1569.8,15,1,0,5,6,3,1,0,1,0,16841,7.0,18327,259,50,1143,859,25.9,1684.1
4510857801,0,14,4,0,8,11,10,0,0,0,0,18452,7.0,17864,241,42,-69,-634,24.1,1845.2,15,5,1,11,8,10,2,1,1,0,18521,7.0,18498,180,60,69,634,18.0,1852.1
4464260583,0,142,1,0,4,5,4,0,0,0,0,14569,6.6,17180,194,49,-1195,-56,19.4,1456.9,13,3,1,5,4,6,1,1,0,0,15764,6.6,17236,194,54,1195,56,19.4,1576.4
4483634862,0,14,1,0,5,12,5,0,0,0,0,15634,6.6,16435,222,40,-3194,-2675,22.2,1563.4,50,2,1,12,5,13,1,0,1,0,18828,7.2,19110,205,52,3194,2675,20.5,1882.8
4484558599,0,12,0,0,1,9,1,1,1,0,0,13727,6.6,16509,207,62,-5000,-4822,20.7,1372.7,27,2,1,9,1,6,0,0,0,0,18727,7.6,21331,254,77,5000,4822,25.4,1872.7
4478442838,0,16,5,0,10,11,14,0,0,0,0,17056,6.6,17190,167,39,-1603,-1406,16.7,1705.6,19,2,1,11,10,11,2,1,1,0,18659,7.0,18596,229,49,1603,1406,22.9,1865.9
4525161155,0,13,3,0,4,8,5,1,0,1,0,15577,6.6,16808,235,42,-2268,-1851,23.5,1557.7,21,3,1,8,4,7,1,1,0,0,17845,7.0,18659,239,63,2268,1851,23.9,1784.5
4486920046,0,13,2,0,4,9,3,0,0,0,0,15027,6.6,16491,216,44,-3148,-2107,21.6,1502.7,16,2,1,9,4,9,1,1,0,0,18175,7.0,18598,220,56,3148,2107,22.0,1817.5
4509570260,0,19,4,0,1,6,1,0,0,0,0,15459,7.0,18187,243,71,-2483,-1894,24.3,1545.9,18,5,1,6,1,7,2,1,1,0,17942,7.4,20081,254,72,2483,1894,25.4,1794.2
4502652617,0,11,0,1,5,5,3,1,0,1,0,16993,7.0,18944,241,67,1140,-531,24.1,1699.3,12,1,0,5,5,5,1,1,0,0,15853,7.0,19475,231,60,-1140,531,23.1,1585.3
4456819413,0,29,3,0,5,7,8,0,0,0,0,15796,6.6,17121,184,49,-1044,-487,18.4,1579.6,18,2,1,7,5,11,1,1,0,0,16840,7.0,17608,226,49,1044,487,22.6,1684.0
4509881889,0,20,4,0,3,5,4,1,1,0,0,15557,7.0,18380,251,56,-101,-380,25.1,1555.7,14,1,1,5,3,2,0,0,0,0,15658,7.2,18760,210,64,101,380,21.0,1565.8
4525297517,0,18,4,1,7,8,7,0,0,0,0,16927,6.8,17042,223,42,-498,-861,22.3,1692.7,21,3,0,8,7,7,0,0,0,0,17425,7.0,17903,228,51,498,861,22.8,1742.5
4438426870,0,18,0,0,6,7,2,0,0,0,0,15141,6.8,17975,196,33,-770,196,19.6,1514.1,17,2,1,7,6,10,1,1,0,0,15911,6.8,17779,178,40,770,-196,17.8,1591.1
4524532805,0,10,1,0,6,6,5,1,1,0,0,16490,7.0,19578,214,68,-392,462,21.4,1649.0,16,1,1,6,6,8,0,0,0,0,16882,7.2,19116,232,56,392,-462,23.2,1688.2
4525551314,0,11,2,1,10,4,10,0,0,0,1,19095,7.2,19444,219,44,2999,2184,21.9,1909.5,12,1,0,4,10,2,0,0,0,0,16096,6.6,17260,204,48,-2999,-2184,20.4,1609.6
4515418492,0,18,1,1,3,7,3,0,0,0,0,14951,6.8,17632,206,48,-2002,-565,20.6,1495.1,15,2,0,7,3,6,1,1,0,0,16953,7.0,18197,214,59,2002,565,21.4,1695.3
4505464624,0,22,3,0,4,7,2,1,1,0,0,15125,6.8,17495,200,55,-2302,-702,20.0,1512.5,16,0,1,7,4,9,0,0,0,0,17427,6.8,18197,207,48,2302,702,20.7,1742.7
4501457414,0,13,1,0,5,7,8,0,0,0,0,16334,7.0,18034,245,40,-1337,-1106,24.5,1633.4,85,1,1,7,5,9,2,1,1,0,17671,7.2,19140,245,60,1337,1106,24.5,1767.1
4470743478,0,15,3,1,9,10,9,1,1,0,0,17633,7.0,18304,218,51,-811,-410,21.8,1763.3,23,3,0,10,9,11,0,0,0,0,18444,7.0,18714,230,44,811,410,23.0,1844.4
4510706282,0,17,2,0,6,2,7,1,0,1,0,16646,7.2,18530,226,51,2352,1002,22.6,1664.6,12,1,1,2,6,2,1,1,0,0,14294,6.8,17528,210,60,-2352,-1002,21.0,1429.4
4458264663,0,16,2,0,3,9,4,0,0,0,0,14471,7.0,17643,208,40,-3385,-2781,20.8,1447.1,16,7,1,9,3,8,1,1,0,0,17856,7.4,20424,223,44,3385,2781,22.3,1785.6
4495369305,0,13,1,0,2,6,2,0,0,0,0,15392,7.0,18126,238,60,-1045,406,23.8,1539.2,14,2,1,6,2,7,2,1,1,0,16437,6.8,17720,205,64,1045,-406,20.5,1643.7
4521611009,0,13,2,1,7,12,9,0,0,0,0,15938,6.2,14724,194,36,-1985,-3666,19.4,1593.8,40,2,0,12,7,13,1,1,0,0,17923,7.2,18390,187,44,1985,3666,18.7,1792.3
4516392840,0,9,3,1,7,7,6,1,0,1,0,17634,7.2,18416,237,52,825,-1367,23.7,1763.4,14,0,0,7,7,4,1,1,0,0,16809,7.0,19783,215,59,-825,1367,21.5,1680.9
4509595307,0,38,4,0,2,5,2,0,0,0,0,13889,6.8,16733,193,57,-1656,-453,19.3,1388.9,13,3,1,5,2,8,1,1,0,0,15545,6.6,17186,229,44,1656,453,22.9,1554.5
4515910036,0,18,2,0,4,3,4,0,0,0,0,15987,7.0,18632,252,52,1033,372,25.2,1598.7,15,3,1,3,4,3,0,0,0,0,14954,7.0,18260,231,52,-1033,-372,23.1,1495.4
4519157822,0,28,2,1,9,6,11,0,0,0,0,17210,6.6,17039,195,36,643,-8,19.5,1721.0,15,6,0,6,9,8,0,0,0,0,16567,6.8,17047,197,55,-643,8,19.7,1656.7
4470106010,0,19,3,0,6,5,4,1,1,0,0,16000,7.2,18965,181,79,230,1894,18.1,1600.0,14,3,1,5,6,4,0,0,0,0,15770,6.8,17071,236,36,-230,-1894,23.6,1577.0
4508898898,0,14,2,0,6,11,5,0,0,0,0,16167,7.0,18659,202,60,-2055,-214,20.2,1616.7,18,5,1,11,6,11,2,1,1,0,18222,7.2,18873,204,56,2055,214,20.4,1822.2
4494587066,0,14,1,0,6,7,7,1,0,1,1,17927,6.8,18100,213,45,396,-1813,21.3,1792.7,36,2,1,7,6,8,1,1,0,0,17531,7.4,19913,229,73,-396,1813,22.9,1753.1
4505558146,0,43,3,0,4,7,8,0,0,0,0,15462,6.6,17446,209,54,-2237,-885,20.9,1546.2,14,7,1,7,4,12,1,1,0,0,17699,6.8,18331,256,46,2237,885,25.6,1769.9
4486168054,0,23,1,1,5,11,6,0,0,0,0,15696,6.6,16453,195,42,-2942,-1785,19.5,1569.6,17,7,0,11,5,14,0,0,0,0,18638,7.0,18238,212,47,2942,1785,21.2,1863.8
4487935586,0,43,0,0,4,6,4,0,0,0,0,14844,7.0,17089,187,51,-933,-636,18.7,1484.4,18,2,1,6,4,6,1,0,1,0,15777,7.0,17725,217,31,933,636,21.7,1577.7
4497709596,0,17,2,1,5,10,5,2,1,1,0,16486,7.0,18609,244,56,-2249,-1547,24.4,1648.6,17,2,0,10,5,12,0,0,0,0,18735,7.4,20156,214,72,2249,1547,21.4,1873.5
4447641028,0,79,1,1,11,14,10,0,0,0,0,16978,5.6,13699,158,28,-4259,-3503,15.8,1697.8,28,3,0,14,11,21,1,0,1,2,21237,7.0,17202,203,34,4259,3503,20.3,2123.7
4491793322,0,14,2,0,0,11,0,1,0,1,0,13475,6.2,15686,206,71,-5840,-2412,20.6,1347.5,16,6,1,11,0,16,1,1,0,0,19315,7.0,18098,262,49,5840,2412,26.2,1931.5
4483650027,0,17,3,0,1,6,1,0,0,0,0,14325,6.8,17432,235,57,-1887,-587,23.5,1432.5,17,4,1,6,1,10,1,1,0,0,16212,7.2,18019,228,52,1887,587,22.8,1621.2
4524995748,0,20,1,0,2,7,3,1,1,0,0,14358,6.6,16775,225,53,-2031,-1121,22.5,1435.8,17,2,1,7,2,6,0,0,0,0,16389,7.0,17896,223,37,2031,1121,22.3,1638.9
4517858736,0,14,2,1,6,3,7,0,0,0,0,16310,7.0,18578,235,48,690,998,23.5,1631.0,18,1,0,3,6,5,1,1,0,0,15620,6.8,17580,230,40,-690,-998,23.0,1562.0
4526910124,0,13,1,1,7,6,9,0,0,0,0,17740,7.0,18658,252,37,1419,1036,25.2,1774.0,13,5,0,6,7,7,2,1,1,0,16321,6.8,17622,215,56,-1419,-1036,21.5,1632.1
4523304225,0,15,0,1,7,8,15,1,1,0,0,15381,6.2,14805,167,39,-1611,-1901,16.7,1538.1,13,2,0,8,7,8,0,0,0,0,16992,6.6,16706,201,53,1611,1901,20.1,1699.2
4520010999,0,18,3,0,3,7,3,1,1,0,0,15335,6.6,17368,234,60,-1716,-1601,23.4,1533.5,16,6,1,7,3,5,0,0,0,0,17051,7.2,18969,262,36,1716,1601,26.2,1705.1
4524384067,0,43,1,0,4,5,5,1,0,1,0,15157,7.0,17954,201,55,-1321,-7,20.1,1515.7,15,2,1,5,4,10,0,0,0,0,16478,7.0,17961,235,47,1321,7,23.5,1647.8
4527044797,0,15,0,0,5,10,5,0,0,0,0,15954,6.8,16521,192,56,-2527,-2193,19.2,1595.4,14,3,1,10,5,8,1,1,0,0,18481,7.4,18714,197,80,2527,2193,19.7,1848.1
4465596531,0,12,3,1,10,6,4,0,0,0,0,18000,7.4,19946,236,48,2504,2361,23.6,1800.0,16,1,0,6,10,7,0,0,0,0,15496,7.0,17585,191,43,-2504,-2361,19.1,1549.6
4525381159,0,16,5,0,5,12,5,1,1,0,0,14819,6.8,16721,164,47,-4413,-3537,16.4,1481.9,39,7,1,12,5,8,0,0,0,0,19232,7.4,20258,242,42,4413,3537,24.2,1923.2
4491896790,0,18,4,0,5,4,7,0,0,0,0,15881,6.8,17469,239,44,76,98,23.9,1588.1,15,5,1,4,5,6,1,1,0,0,15805,6.8,17371,249,52,-76,-98,24.9,1580.5
4508772592,0,12,1,0,2,11,3,0,0,0,0,14384,7.0,17020,237,40,-6124,-4043,23.7,1438.4,13,2,1,11,2,8,1,1,0,0,20508,7.6,21063,252,64,6124,4043,25.2,2050.8
4523720139,0,13,2,1,1,1,0,1,0,1,0,14737,7.0,18532,229,59,92,728,22.9,1473.7,11,2,0,1,1,0,0,0,0,0,14645,6.8,17804,199,59,-92,-728,19.9,1464.5
4456745249,0,26,3,0,1,8,1,1,0,1,0,14044,6.8,16385,231,44,-4107,-3090,23.1,1404.4,20,6,1,8,1,12,1,1,0,0,18151,7.4,19475,234,60,4107,3090,23.4,1815.1
4521458621,0,105,2,0,3,8,2,0,0,0,0,14533,6.8,17818,198,56,-4033,-1850,19.8,1453.3,14,2,1,8,3,9,1,1,0,0,18566,7.2,19668,220,64,4033,1850,22.0,1856.6
4520827057,0,16,3,1,2,5,3,0,0,0,0,15053,6.8,17983,248,53,-3526,-1273,24.8,1505.3,37,3,0,5,2,9,0,0,0,0,18579,7.2,19256,234,53,3526,1273,23.4,1857.9
4478851692,0,13,3,0,4,7,5,0,0,0,0,15614,7.0,17578,241,53,-816,172,24.1,1561.4,32,3,1,7,4,9,1,1,0,0,16430,6.8,17406,234,38,816,-172,23.4,1643.0
4522622334,0,55,2,0,6,7,8,2,1,1,0,16289,6.8,17723,208,56,-963,-64,20.8,1628.9,14,6,1,7,6,11,0,0,0,0,17252,7.0,17787,230,56,963,64,23.0,1725.2
4419866013,0,16,3,0,8,6,12,1,1,0,0,16879,7.0,18288,199,44,45,-351,19.9,1687.9,27,4,1,6,8,5,0,0,0,0,16834,7.0,18639,254,49,-45,351,25.4,1683.4
4459896509,0,44,2,1,7,5,3,2,1,1,0,16066,6.8,17944,224,50,-1247,400,22.4,1606.6,15,3,0,5,7,3,0,0,0,1,17313,6.8,17544,225,55,1247,-400,22.5,1731.3
4519106569,0,18,6,1,5,3,4,1,1,0,0,16379,6.8,18268,240,44,1429,1224,24.0,1637.9,20,4,0,3,5,4,0,0,0,0,14950,6.8,17044,226,52,-1429,-1224,22.6,1495.0
4509926355,0,16,1,0,5,9,4,1,0,1,0,15539,6.4,16163,163,50,-1337,-1246,16.3,1553.9,18,2,1,9,5,9,0,0,0,0,16876,7.0,17409,190,42,1337,1246,19.0,1687.6
4474968452,0,18,4,1,4,4,7,0,0,0,0,16487,7.0,18146,229,60,995,-458,22.9,1648.7,16,3,0,4,4,2,0,0,0,0,15492,7.0,18604,230,56,-995,458,23.0,1549.2
4525070748,0,19,2,1,9,3,8,0,0,0,0,17049,6.8,17241,202,41,1863,328,20.2,1704.9,17,2,0,3,9,5,0,0,0,0,15186,6.8,16913,204,58,-1863,-328,20.4,1518.6
4476985915,0,40,5,0,3,5,4,0,0,0,0,14710,6.8,16797,227,34,-1799,-1942,22.7,1471.0,19,4,1,5,3,8,1,1,0,0,16509,7.0,18739,204,75,1799,1942,20.4,1650.9
4509363345,0,40,2,1,6,8,9,0,0,0,0,16185,6.8,17924,204,40,-2100,-925,20.4,1618.5,14,20,0,8,6,12,2,1,1,1,18285,7.0,18849,199,40,2100,925,19.9,1828.5
4518305583,0,18,4,1,11,10,16,0,0,0,0,18453,7.0,18299,204,34,466,-316,20.4,1845.3,14,4,0,10,11,14,0,0,0,0,17987,7.4,18615,186,46,-466,316,18.6,1798.7
4446215269,0,11,2,0,5,12,4,0,0,0,0,16154,6.8,18081,216,44,-2129,-2255,21.6,1615.4,25,2,1,12,5,12,0,0,0,0,18283,7.4,20336,206,72,2129,2255,20.6,1828.3
4513317903,0,18,4,0,6,10,3,1,1,0,0,15602,6.4,16415,206,45,-3060,-2937,20.6,1560.2,18,8,1,10,6,7,0,0,0,0,18662,7.4,19352,238,48,3060,2937,23.8,1866.2
4522558200,0,39,1,1,7,4,6,0,0,0,0,15885,7.2,19056,207,52,125,2058,20.7,1588.5,22,5,0,4,7,4,0,0,0,0,15760,6.8,16998,224,47,-125,-2058,22.4,1576.0
4511951461,0,15,3,1,2,8,1,1,0,1,0,14014,6.6,16219,205,48,-3443,-2284,20.5,1401.4,17,3,0,8,2,8,0,0,0,0,17457,7.2,18503,230,52,3443,2284,23.0,1745.7
4519902539,0,40,4,0,6,6,4,0,0,0,0,15823,7.0,18209,214,52,-1482,256,21.4,1582.3,17,3,1,6,6,8,1,1,0,0,17305,6.8,17953,247,62,1482,-256,24.7,1730.5
4497486422,0,23,4,1,7,10,8,1,0,1,1,18063,6.6,16794,228,48,-163,-674,22.8,1806.3,16,3,0,10,7,19,1,1,0,0,18226,6.8,17468,201,58,163,674,20.1,1822.6
4523694743,0,106,4,0,3,10,4,1,1,0,0,14385,6.4,15780,195,42,-4413,-3109,19.5,1438.5,16,1,1,10,3,12,1,0,1,0,18798,7.0,18889,234,41,4413,3109,23.4,1879.8
4518499489,0,16,2,0,2,11,2,0,0,0,0,13494,5.8,14660,213,24,-5020,-4792,21.3,1349.4,14,3,1,11,2,9,1,1,0,0,18514,7.4,19452,246,57,5020,4792,24.6,1851.4
4520611653,0,17,3,0,6,11,5,0,0,0,0,16864,7.0,18758,219,49,-1406,-1006,21.9,1686.4,15,1,1,11,6,12,0,0,0,0,18270,7.2,19764,195,67,1406,1006,19.5,1827.0
4483910758,0,12,3,0,3,5,2,1,0,1,0,15385,7.0,17822,227,56,-989,-1102,22.7,1538.5,15,4,1,5,3,3,1,1,0,0,16374,7.4,18924,224,63,989,1102,22.4,1637.4
4513054868,0,12,0,1,6,9,3,0,0,0,0,15896,6.8,17492,171,67,-1773,-422,17.1,1589.6,11,0,0,9,6,10,1,1,0,0,17669,6.8,17914,221,48,1773,422,22.1,1766.9
4515305761,0,14,1,1,7,6,7,0,0,0,0,17513,7.2,18336,228,51,1941,846,22.8,1751.3,121,3,0,6,7,5,1,0,1,0,15572,6.6,17490,188,48,-1941,-846,18.8,1557.2
4488824515,0,16,3,1,7,9,4,1,1,0,0,16808,6.8,17370,231,38,-361,1686,23.1,1680.8,18,2,0,9,7,13,0,0,0,0,17169,6.4,15684,214,35,361,-1686,21.4,1716.9
4525369835,0,41,2,0,2,7,4,1,1,0,0,15032,7.0,18462,232,68,-2785,-453,23.2,1503.2,22,3,1,7,2,7,1,0,1,0,17817,7.2,18915,228,55,2785,453,22.8,1781.7
4448363210,0,15,1,0,2,11,3,0,0,0,0,14773,6.6,16673,202,53,-4125,-2712,20.2,1477.3,17,6,1,11,2,11,1,1,0,0,18898,7.2,19385,237,50,4125,2712,23.7,1889.8
4520688318,0,54,4,0,11,6,22,1,0,1,0,18640,7.0,18015,226,48,1931,1200,22.6,1864.0,13,2,1,6,11,10,1,1,0,0,16709,6.6,16815,232,62,-1931,-1200,23.2,1670.9
4525296321,0,15,0,1,2,4,2,0,0,0,0,15210,6.8,17457,222,45,262,-414,22.2,1521.0,15,1,0,4,2,5,2,1,1,0,14948,7.0,17871,216,46,-262,414,21.6,1494.8
4509249134,0,17,2,1,4,11,4,1,1,0,0,16231,7.2,18316,211,56,-2932,-2135,21.1,1623.1,40,2,0,11,4,15,0,0,0,0,19163,7.4,20451,215,52,2932,2135,21.5,1916.3
4520766314,0,16,4,1,9,3,13,1,1,0,0,17941,7.2,18842,205,52,2361,770,20.5,1794.1,17,2,0,3,9,3,0,0,0,0,15580,6.8,18072,249,52,-2361,-770,24.9,1558.0
4516722910,0,15,1,0,7,10,11,0,0,0,0,15723,6.4,15809,159,44,-4307,-2260,15.9,1572.3,17,0,1,10,7,13,1,0,1,1,20030,7.0,18069,253,40,4307,2260,25.3,2003.0
4524371920,0,11,4,1,6,7,3,1,0,1,0,16568,7.0,18066,215,60,-727,322,21.5,1656.8,15,2,0,7,6,10,1,1,0,0,17295,7.0,17744,211,42,727,-322,21.1,1729.5
4417362254,0,13,2,1,5,4,5,1,0,1,0,17564,7.4,20203,257,73,1369,1440,25.7,1756.4,19,4,0,4,5,5,1,1,0,0,16195,7.2,18763,233,43,-1369,-1440,23.3,1619.5
4502952363,0,78,3,1,7,7,15,0,0,0,0,16250,6.8,17026,157,54,-1661,-1369,15.7,1625.0,19,5,0,7,7,9,0,0,0,0,17911,7.2,18395,243,51,1661,1369,24.3,1791.1
4502456299,0,80,1,1,5,5,5,0,0,0,0,15161,6.6,17135,174,40,-106,-827,17.4,1516.1,19,1,0,5,5,5,1,1,0,0,15267,6.8,17962,207,51,106,827,20.7,1526.7
4524504649,0,15,3,1,10,4,15,2,1,1,0,18959,7.2,19473,244,60,3373,1784,24.4,1895.9,13,2,0,4,10,2,0,0,0,0,15586,6.8,17689,221,47,-3373,-1784,22.1,1558.6
4511106120,0,16,2,0,1,8,2,0,0,0,0,14055,6.6,16334,208,55,-4331,-2588,20.8,1405.5,43,4,1,8,1,10,1,1,0,0,18386,7.2,18922,226,56,4331,2588,22.6,1838.6
4480198184,0,18,1,0,6,10,9,0,0,0,0,16853,7.0,18059,225,44,-1590,-1867,22.5,1685.3,12,2,1,10,6,9,1,1,0,0,18443,7.2,19926,242,55,1590,1867,24.2,1844.3
4524415638,0,15,2,1,5,6,4,0,0,0,0,15109,7.0,18112,213,43,-1493,-382,21.3,1510.9,98,3,0,6,5,2,1,1,0,0,16602,7.0,18494,230,52,1493,382,23.0,1660.2
4502030084,0,20,1,0,4,7,4,0,0,0,0,14696,6.6,16517,202,41,-2688,-1172,20.2,1469.6,53,4,1,7,4,5,1,1,0,0,17384,7.0,17689,212,56,2688,1172,21.2,1738.4
4500092661,0,17,4,0,4,8,5,1,1,0,0,15591,7.0,17848,228,59,-1951,-1575,22.8,1559.1,19,4,1,8,4,6,0,0,0,0,17542,7.4,19423,236,42,1951,1575,23.6,1754.2
4470228230,0,13,0,0,3,5,3,0,0,0,0,15136,6.8,17202,216,52,-401,-995,21.6,1513.6,11,2,1,5,3,2,0,0,0,0,15537,7.0,18197,240,40,401,995,24.0,1553.7
4482052361,0,19,6,0,2,8,4,0,0,0,0,13698,6.2,15671,222,33,-4907,-2556,22.2,1369.8,18,7,1,8,2,11,1,0,1,1,18605,7.0,18227,242,40,4907,2556,24.2,1860.5
4514189275,0,11,2,0,8,6,9,0,0,0,0,17304,7.2,19455,233,52,1127,1908,23.3,1730.4,7,1,1,6,8,5,1,1,0,0,16177,6.8,17547,211,52,-1127,-1908,21.1,1617.7
4507071282,0,14,19,0,2,11,2,0,0,0,0,13671,6.8,16878,202,47,-5751,-4242,20.2,1367.1,62,4,1,11,2,12,1,1,0,0,19422,7.6,21120,259,48,5751,4242,25.9,1942.2
4478851132,0,16,4,0,6,9,3,1,0,1,1,16840,7.2,18376,221,40,-990,-2014,22.1,1684.0,24,6,1,9,6,7,1,1,0,0,17830,7.4,20390,247,52,990,2014,24.7,1783.0
4498058442,0,38,2,1,3,5,2,0,0,0,0,14452,6.4,15418,186,49,-1404,-2296,18.6,1445.2,18,2,0,5,3,3,1,1,0,0,15856,6.8,17714,228,56,1404,2296,22.8,1585.6
4482569036,0,24,0,1,4,7,5,0,0,0,0,15267,6.8,17008,212,52,-1002,-2319,21.2,1526.7,12,3,0,7,4,9,1,0,1,0,16269,7.0,19327,209,60,1002,2319,20.9,1626.9
4494911672,0,17,4,0,4,5,3,1,1,0,0,16675,7.2,18462,240,72,93,1943,24.0,1667.5,18,4,1,5,4,7,0,0,0,0,16582,6.6,16519,209,46,-93,-1943,20.9,1658.2
4505621420,0,16,1,0,3,7,2,1,0,1,1,16532,6.8,18522,245,52,151,878,24.5,1653.2,41,6,1,7,3,9,1,1,0,0,16381,7.0,17644,215,40,-151,-878,21.5,1638.1
4519833399,0,17,1,0,6,6,4,1,0,1,0,16533,7.0,18187,217,61,85,765,21.7,1653.3,14,2,1,6,6,9,0,0,0,0,16448,6.8,17422,214,46,-85,-765,21.4,1644.8
4451891772,0,15,3,0,7,9,4,0,0,0,0,15002,6.4,15784,170,37,-3255,-1798,17.0,1500.2,14,4,1,9,7,10,1,1,0,0,18257,7.0,17582,240,46,3255,1798,24.0,1825.7
4487380203,0,17,1,0,2,8,1,1,1,0,0,14476,6.6,16263,201,57,-4094,-3320,20.1,1447.6,18,2,1,8,2,8,0,0,0,0,18570,7.2,19583,252,66,4094,3320,25.2,1857.0
4523722482,0,14,3,0,6,5,8,2,1,1,0,16302,7.2,18772,231,46,336,936,23.1,1630.2,16,0,1,5,6,5,0,0,0,0,15966,7.0,17836,223,44,-336,-936,22.3,1596.6
4485867015,0,16,1,1,7,8,4,1,1,0,0,15863,7.0,18126,178,58,-735,-742,17.8,1586.3,17,0,0,8,7,3,0,0,0,0,16598,7.0,18868,231,56,735,742,23.1,1659.8
4521066118,0,15,3,0,1,7,2,1,1,0,0,13449,6.6,16281,205,45,-4357,-4959,20.5,1344.9,54,4,1,7,1,9,0,0,0,0,17806,7.6,21240,226,79,4357,4959,22.6,1780.6
4505777098,0,91,0,1,3,7,2,0,0,0,0,14725,6.6,17519,210,36,-2686,-1780,21.0,1472.5,12,3,0,7,3,11,0,0,0,0,17411,7.2,19299,242,39,2686,1780,24.2,1741.1
4520990343,0,18,2,0,9,6,9,0,0,0,0,17854,7.2,18784,219,43,1762,2377,21.9,1785.4,16,2,1,6,9,7,1,0,1,0,16092,6.6,16407,202,40,-1762,-2377,20.2,1609.2
4517679097,0,13,3,0,7,5,8,1,1,0,0,17182,7.2,18588,233,64,1276,1161,23.3,1718.2,16,1,1,5,7,8,0,0,0,0,15906,6.8,17427,213,52,-1276,-1161,21.3,1590.6
4456684874,0,17,1,0,4,9,2,0,0,0,0,15445,6.6,17280,222,51,-1775,-2698,22.2,1544.5,11,6,1,9,4,6,1,0,1,0,17220,7.4,19978,228,38,1775,2698,22.8,1722.0
4523296034,0,41,4,0,4,12,4,0,0,0,0,14957,6.8,17705,173,63,-3881,-447,17.3,1495.7,17,3,1,12,4,12,0,0,0,0,18838,7.0,18152,223,44,3881,447,22.3,1883.8
4527865649,0,17,2,0,7,8,9,1,0,1,0,17394,6.8,17904,261,32,188,-676,26.1,1739.4,29,4,1,8,7,7,0,0,0,0,17206,7.0,18580,212,56,-188,676,21.2,1720.6
4471153063,0,15,1,1,9,7,8,0,0,0,0,19122,7.2,19334,238,56,3089,1750,23.8,1912.2,12,1,0,7,9,10,0,0,0,0,16033,6.8,17584,169,52,-3089,-1750,16.9,1603.3
4523498928,0,9,0,0,2,9,1,0,0,0,0,13879,6.2,15363,185,48,-4267,-3389,18.5,1387.9,15,2,1,9,2,5,2,1,1,0,18146,7.0,18752,232,56,4267,3389,23.2,1814.6
4509468172,0,34,4,0,6,7,0,1,0,1,0,16338,7.0,18577,223,64,-524,468,22.3,1633.8,17,3,1,7,6,11,1,1,0,0,16862,7.0,18109,209,41,524,-468,20.9,1686.2
4525350807,0,14,3,0,5,4,3,0,0,0,0,16293,6.8,17793,218,55,1006,1171,21.8,1629.3,17,2,1,4,5,5,1,1,0,0,15287,6.6,16622,207,52,-1006,-1171,20.7,1528.7
4524217548,0,17,1,0,5,10,6,0,0,0,0,16249,7.0,18383,213,59,-1796,-749,21.3,1624.9,16,2,1,10,5,15,1,1,0,0,18045,7.0,19132,214,44,1796,749,21.4,1804.5
4521833199,0,16,4,0,2,2,2,0,0,0,0,15280,7.2,18773,257,64,447,609,25.7,1528.0,16,3,1,2,2,2,1,1,0,0,14833,6.8,18164,240,51,-447,-609,24.0,1483.3
4473264225,0,18,1,1,6,15,9,0,0,0,0,16205,6.4,15951,171,44,-3719,-3695,17.1,1620.5,42,3,0,15,6,14,1,1,0,0,19924,7.4,19646,216,48,3719,3695,21.6,1992.4
4491485082,0,24,3,1,3,2,5,1,0,1,0,14783,6.6,16564,205,54,401,95,20.5,1478.3,18,6,0,2,3,4,1,1,0,0,14382,6.8,16469,209,42,-401,-95,20.9,1438.2
4521602868,0,20,5,1,8,6,13,1,1,0,0,17731,6.8,18132,232,47,1375,109,23.2,1773.1,19,1,0,6,8,4,0,0,0,0,16356,6.8,18023,206,48,-1375,-109,20.6,1635.6
4525370217,0,54,8,0,5,7,10,1,1,0,0,15844,6.6,16971,209,51,-2270,-2033,20.9,1584.4,29,3,1,7,5,9,0,0,0,0,18114,7.2,19004,243,64,2270,2033,24.3,1811.4
4520879335,0,13,4,0,5,10,5,0,0,0,0,16925,6.6,18087,233,64,-962,107,23.3,1692.5,17,3,1,10,5,16,1,1,0,0,17887,7.0,17980,213,44,962,-107,21.3,1788.7
4508010567,0,19,2,0,8,6,12,0,0,0,0,15958,6.6,17066,185,44,231,-184,18.5,1595.8,13,3,1,6,8,2,1,1,0,0,15727,6.8,17250,208,48,-231,184,20.8,1572.7
4459193358,0,13,4,0,4,5,2,1,0,1,0,14366,6.8,17267,207,37,-1614,15,20.7,1436.6,17,0,1,5,4,9,1,1,0,0,15980,7.0,17252,216,62,1614,-15,21.6,1598.0
4426693677,0,20,4,1,15,6,12,0,0,0,0,18863,7.2,18943,195,52,2789,585,19.5,1886.3,38,4,0,6,15,4,0,0,0,0,16074,7.0,18358,192,52,-2789,-585,19.2,1607.4
4516181057,0,12,2,0,3,12,4,0,0,0,0,14015,6.4,15677,178,36,-4929,-3345,17.8,1401.5,15,3,1,12,3,16,1,1,0,0,18944,7.2,19022,228,48,4929,3345,22.8,1894.4
4523433938,0,16,0,0,3,4,4,0,0,0,0,15875,6.8,17351,241,42,186,-273,24.1,1587.5,38,5,1,4,3,4,0,0,0,0,15689,7.2,17624,232,45,-186,273,23.2,1568.9
4527042510,0,20,1,1,12,4,14,2,1,1,0,19339,7.2,19966,225,66,3708,2901,22.5,1933.9,83,3,0,4,12,3,0,0,0,0,15631,6.8,17065,203,60,-3708,-2901,20.3,1563.1
4470087448,0,18,2,1,3,8,4,0,0,0,0,14663,6.6,15749,201,41,-2454,-3816,20.1,1466.3,16,1,0,8,3,8,1,0,1,0,17117,7.4,19565,213,50,2454,3816,21.3,1711.7
4519482984,0,15,6,0,3,8,2,1,1,0,0,14122,6.6,15708,188,40,-2968,-2159,18.8,1412.2,19,4,1,8,3,7,0,0,0,0,17090,7.0,17867,182,47,2968,2159,18.2,1709.0
4524056834,0,17,2,0,8,3,10,1,1,0,0,17084,7.2,18781,219,52,2148,1700,21.9,1708.4,15,4,1,3,8,2,0,0,0,0,14936,6.4,17081,217,52,-2148,-1700,21.7,1493.6
4507744435,0,14,1,0,2,7,1,0,0,0,0,14873,6.8,17781,205,72,-2304,31,20.5,1487.3,15,1,1,7,2,9,1,1,0,0,17177,7.0,17750,238,44,2304,-31,23.8,1717.7
4489945010,0,14,5,0,1,5,2,0,0,0,0,13736,6.6,15897,180,68,-2301,-2659,18.0,1373.6,15,2,1,5,1,3,2,1,1,0,16037,7.2,18556,226,60,2301,2659,22.6,1603.7
4477952218,0,18,5,1,2,3,1,0,0,0,0,15219,6.8,17357,241,48,-563,-1422,24.1,1521.9,19,5,0,3,2,3,1,1,0,0,15782,7.0,18779,225,68,563,1422,22.5,1578.2
4527566867,0,22,1,0,2,6,0,0,0,0,0,14485,6.8,17588,233,64,-1422,-861,23.3,1448.5,68,0,1,6,2,7,1,1,0,0,15907,7.0,18449,235,56,1422,861,23.5,1590.7
4504974041,0,13,1,1,2,4,2,0,0,0,0,14651,6.8,18301,241,41,-1991,-1055,24.1,1465.1,15,1,0,4,2,4,0,0,0,0,16642,7.2,19356,248,78,1991,1055,24.8,1664.2
4518092454,0,15,3,0,5,9,5,0,0,0,0,15529,6.8,17544,200,52,-2347,-1346,20.0,1552.9,14,2,1,9,5,9,1,0,1,0,17876,7.2,18890,229,55,2347,1346,22.9,1787.6
4526667175,0,17,5,0,3,7,3,1,1,0,0,14322,6.4,16812,186,60,-3441,-1732,18.6,1432.2,21,4,1,7,3,9,1,0,1,0,17763,7.0,18544,227,48,3441,1732,22.7,1776.3
4515413572,0,66,2,1,6,6,6,1,0,1,0,16124,6.6,17227,225,24,-725,-925,22.5,1612.4,14,4,0,6,6,6,1,1,0,0,16849,6.8,18152,246,54,725,925,24.6,1684.9
4448491393,0,19,3,0,0,6,0,0,0,0,0,13395,6.8,16282,207,47,-3275,-3254,20.7,1339.5,20,3,1,6,0,5,0,0,0,0,16670,7.2,19536,257,40,3275,3254,25.7,1667.0
4455419098,0,15,4,1,7,9,4,0,0,0,0,15947,7.0,17802,204,56,-2086,-2017,20.4,1594.7,18,4,0,9,7,10,1,1,0,0,18033,7.2,19819,188,64,2086,2017,18.8,1803.3
4495054674,0,53,5,0,5,9,5,1,1,0,0,15535,6.8,17403,207,53,-4205,-1540,20.7,1553.5,20,4,1,9,5,10,0,0,0,1,19740,7.4,18943,251,44,4205,1540,25.1,1974.0
4522444254,0,13,1,1,3,8,2,0,0,0,0,15404,6.8,17439,240,56,-3096,-3752,24.0,1540.4,38,5,0,8,3,11,1,1,0,0,18500,7.6,21191,256,76,3096,3752,25.6,1850.0
4462936541,0,14,4,0,9,11,7,0,0,0,0,17137,7.0,18112,188,46,-1730,24,18.8,1713.7,12,4,1,11,9,11,2,1,1,0,18867,7.0,18088,211,40,1730,-24,21.1,1886.7
4500348663,0,45,1,1,5,4,5,0,0,0,0,15788,6.8,18069,200,56,647,481,20.0,1578.8,19,3,0,4,5,2,2,1,1,0,15141,7.0,17588,228,56,-647,-481,22.8,1514.1
4511705430,0,15,2,1,4,4,3,1,1,0,0,15237,6.8,17162,224,56,-305,242,22.4,1523.7,26,4,0,4,4,5,0,0,0,0,15542,6.4,16920,201,57,305,-242,20.1,1554.2
4526558273,0,14,1,1,8,9,6,1,1,0,0,16889,6.6,16862,198,52,-696,-1472,19.8,1688.9,15,1,0,9,8,6,0,0,0,0,17585,7.0,18334,201,54,696,1472,20.1,1758.5
4512098685,0,20,3,1,12,10,20,0,0,0,0,18269,6.4,16542,198,35,1032,-617,19.8,1826.9,17,3,0,10,12,9,0,0,0,0,17237,6.8,17159,202,36,-1032,617,20.2,1723.7
4442070152,0,15,4,0,5,4,8,0,0,0,0,15552,6.6,17234,201,37,-1493,-1179,20.1,1555.2,18,2,1,4,5,5,1,1,0,0,17045,7.0,18413,250,68,1493,1179,25.0,1704.5
4492936245,0,40,3,0,1,7,1,0,0,0,0,13325,6.6,16064,171,52,-3573,-2497,17.1,1332.5,18,3,1,7,1,12,2,1,1,0,16898,7.2,18561,230,51,3573,2497,23.0,1689.8
4494758719,0,20,1,0,5,5,2,0,0,0,0,15790,6.6,16936,221,48,-175,-624,22.1,1579.0,13,2,1,5,5,5,2,1,1,0,15965,7.0,17560,205,59,175,624,20.5,1596.5
4477116393,0,14,2,0,4,6,5,0,0,0,0,16414,6.8,18297,247,62,-58,-1047,24.7,1641.4,16,3,1,6,4,2,1,1,0,0,16472,7.0,19344,244,60,58,1047,24.4,1647.2
4489579352,0,13,5,1,5,3,5,0,0,0,0,15829,6.8,17771,237,45,968,715,23.7,1582.9,18,2,0,3,5,2,1,1,0,0,14861,6.8,17056,224,44,-968,-715,22.4,1486.1
4522858842,0,11,0,0,2,7,0,0,0,0,0,13371,6.4,15621,224,0,-3170,-2591,22.4,1337.1,12,1,1,7,2,6,1,1,0,0,16541,6.8,18212,226,40,3170,2591,22.6,1654.1
4482030809,0,12,2,0,6,11,6,0,0,0,0,17982,7.0,18687,244,56,-708,387,24.4,1798.2,9,3,1,11,6,9,1,1,0,0,18690,7.2,18300,203,44,708,-387,20.3,1869.0
4485840157,0,14,1,1,6,8,5,0,0,0,0,16892,7.0,18225,226,48,-44,277,22.6,1689.2,14,1,0,8,6,10,1,1,0,0,16936,7.0,17948,185,48,44,-277,18.5,1693.6
4491183408,0,17,0,0,8,10,8,1,0,1,0,18020,7.2,19285,214,63,-533,944,21.4,1802.0,86,1,1,10,8,14,0,0,0,0,18553,7.0,18341,198,52,533,-944,19.8,1855.3
4487273871,0,17,1,0,2,6,0,0,0,0,0,13465,6.2,15462,191,43,-3179,-937,19.1,1346.5,15,2,1,6,2,6,1,1,0,0,16644,6.6,16399,226,43,3179,937,22.6,1664.4
4515286916,0,40,3,1,5,7,7,0,0,0,0,15799,6.4,16589,224,32,-1069,-1901,22.4,1579.9,20,4,0,7,5,5,0,0,0,0,16868,7.0,18490,215,53,1069,1901,21.5,1686.8
4489607487,0,16,2,0,3,6,3,0,0,0,0,15092,7.0,18501,204,70,-1857,-699,20.4,1509.2,19,2,1,6,3,6,2,1,1,0,16949,7.2,19200,252,53,1857,699,25.2,1694.9
4479828060,0,20,1,0,3,5,0,0,0,0,0,13729,6.2,14661,180,36,-1213,-276,18.0,1372.9,16,1,1,5,3,10,2,1,1,0,14942,6.4,14937,161,48,1213,276,16.1,1494.2
4522199667,0,10,0,0,8,10,10,0,0,0,0,17051,7.0,17619,208,42,-530,485,20.8,1705.1,13,3,1,10,8,9,1,1,0,0,17581,6.8,17134,191,40,530,-485,19.1,1758.1
4511051956,0,18,3,1,5,5,4,0,0,0,0,16864,7.0,18195,247,51,874,-554,24.7,1686.4,17,2,0,5,5,5,2,1,1,0,15990,7.2,18749,232,56,-874,554,23.2,1599.0
4459950157,0,18,3,0,4,5,6,1,1,0,0,15871,6.8,17211,229,40,51,-1075,22.9,1587.1,17,5,1,5,4,2,0,0,0,0,15820,7.0,18286,216,52,-51,1075,21.6,1582.0
4471433408,0,16,4,1,10,6,11,1,1,0,0,18001,7.0,18571,216,50,1510,151,21.6,1800.1,14,2,0,6,10,6,0,0,0,0,16491,6.8,18420,231,45,-1510,-151,23.1,1649.1
4524001627,0,16,2,0,5,3,7,0,0,0,0,16210,7.2,17888,226,36,766,-662,22.6,1621.0,36,2,1,3,5,2,0,0,0,0,15444,6.8,18550,202,72,-766,662,20.2,1544.4
4508291469,0,17,0,0,7,8,8,0,0,0,0,16228,6.6,16832,191,44,-1127,-1496,19.1,1622.8,35,1,1,8,7,6,2,1,1,0,17355,7.0,18328,204,53,1127,1496,20.4,1735.5
4499806829,0,15,2,0,3,9,3,0,0,0,0,15002,6.6,16448,217,41,-3545,-3206,21.7,1500.2,39,2,1,9,3,10,2,1,1,0,18547,7.4,19654,224,55,3545,3206,22.4,1854.7
4519612989,0,27,2,0,10,12,13,1,1,0,0,17283,6.4,16235,184,36,-845,-1743,18.4,1728.3,14,5,1,12,10,7,0,0,0,0,18128,6.8,17978,208,68,845,1743,20.8,1812.8
4523340688,0,15,0,0,0,5,0,0,0,0,0,14091,6.4,16184,233,60,-2216,-2730,23.3,1409.1,56,2,1,5,0,8,1,1,0,0,16307,7.0,18914,229,60,2216,2730,22.9,1630.7
4438793603,0,14,3,1,10,4,13,0,0,0,0,18978,7.6,21014,262,56,4185,3377,26.2,1897.8,52,4,0,4,10,3,0,0,0,0,14793,6.8,17637,205,52,-4185,-3377,20.5,1479.3
4502491381,0,12,4,1,6,9,5,0,0,0,0,15967,6.6,17065,217,47,-2162,-2253,21.7,1596.7,41,5,0,9,6,9,0,0,0,0,18129,7.2,19318,224,53,2162,2253,22.4,1812.9
4525014650,0,17,3,0,3,4,4,0,0,0,0,15179,6.8,17410,237,53,-657,-81,23.7,1517.9,65,1,1,4,3,4,2,1,1,0,15836,7.0,17491,237,52,657,81,23.7,1583.6
4499619236,0,44,1,0,7,12,12,1,0,1,0,16548,6.8,17321,192,56,-2775,-2872,19.2,1654.8,28,1,1,12,7,10,1,1,0,0,19323,7.4,20193,220,45,2775,2872,22.0,1932.3
4524647930,0,39,1,0,8,10,9,1,1,0,0,16650,7.0,18077,199,63,-1968,-469,19.9,1665.0,15,3,1,10,8,11,0,0,0,0,18618,7.2,18546,224,44,1968,469,22.4,1861.8
4526787106,0,37,2,1,4,5,4,1,1,0,0,16042,7.0,17865,240,68,-236,711,24.0,1604.2,16,2,0,5,4,8,0,0,0,0,16278,6.8,17154,241,44,236,-711,24.1,1627.8
4492410898,0,16,2,1,7,6,7,0,0,0,0,16440,6.8,17181,197,37,-635,-1449,19.7,1644.0,11,5,0,6,7,8,1,1,0,0,17075,7.0,18630,246,49,635,1449,24.6,1707.5
4460970980,0,15,0,0,3,8,3,0,0,0,0,15036,7.2,17957,198,60,-2855,-2453,19.8,1503.6,15,2,1,8,3,7,1,1,0,0,17891,7.4,20410,269,52,2855,2453,26.9,1789.1
4498314967,0,13,3,0,1,6,2,0,0,0,0,14808,7.2,18642,240,64,-2041,-1090,24.0,1480.8,14,2,1,6,1,6,1,1,0,0,16849,7.4,19732,227,64,2041,1090,22.7,1684.9
4509036476,0,10,3,0,0,5,0,0,0,0,0,12905,6.2,15457,195,44,-3927,-3257,19.5,1290.5,17,3,1,5,0,5,0,0,0,0,16832,7.0,18714,211,78,3927,3257,21.1,1683.2
4524907104,0,35,2,0,4,7,6,2,1,1,0,16234,7.0,18544,218,58,-449,-83,21.8,1623.4,19,1,1,7,4,5,0,0,0,0,16683,7.2,18627,202,60,449,83,20.2,1668.3
4514521054,0,15,4,0,2,9,2,1,1,0,0,14730,6.6,17103,246,41,-4406,-2663,24.6,1473.0,30,1,1,9,2,6,1,0,1,1,19136,7.6,19766,233,60,4406,2663,23.3,1913.6
4521049898,0,14,0,1,6,9,6,0,0,0,0,15821,6.8,17419,208,43,-3364,-1990,20.8,1582.1,139,2,0,9,6,7,1,0,1,1,19185,7.2,19409,230,49,3364,1990,23.0,1918.5
4520706769,0,55,2,1,9,6,8,1,1,0,0,17698,7.2,19290,206,56,726,1104,20.6,1769.8,15,3,0,6,9,5,0,0,0,0,16972,6.8,18186,229,52,-726,-1104,22.9,1697.2
4518246546,0,14,1,0,3,8,4,0,0,0,0,14722,6.4,16433,218,48,-3784,-3051,21.8,1472.2,17,4,1,8,3,12,1,1,0,0,18506,7.2,19484,239,44,3784,3051,23.9,1850.6
4475129478,0,19,2,0,4,6,6,0,0,0,0,15502,6.8,16609,227,42,-938,-729,22.7,1550.2,17,2,1,6,4,5,1,1,0,0,16440,6.8,17338,239,47,938,729,23.9,1644.0
4526966381,0,14,2,0,9,6,8,0,0,0,0,17079,7.0,18150,203,47,899,295,20.3,1707.9,101,4,1,6,9,7,1,1,0,0,16180,7.0,17855,225,36,-899,-295,22.5,1618.0
4527018824,0,21,2,0,2,5,6,1,1,0,0,15476,6.8,17429,237,64,-781,-1559,23.7,1547.6,17,6,1,5,2,3,1,0,1,0,16257,7.2,18988,227,48,781,1559,22.7,1625.7
4495708028,0,13,1,0,5,9,5,0,0,0,0,16841,6.8,17341,234,46,-1482,-724,23.4,1684.1,16,1,1,9,5,11,1,1,0,0,18323,7.0,18065,199,52,1482,724,19.9,1832.3
4477995331,0,66,2,1,8,8,13,0,0,0,0,17191,6.8,17401,188,56,654,478,18.8,1719.1,15,1,0,8,8,9,1,1,0,0,16537,6.6,16923,191,57,-654,-478,19.1,1653.7
4527422917,0,15,5,0,8,8,8,0,0,0,0,17014,6.6,17257,221,33,-426,-1055,22.1,1701.4,17,2,1,8,8,8,0,0,0,0,17440,6.8,18312,204,46,426,1055,20.4,1744.0
4491827833,0,16,0,0,5,10,5,0,0,0,0,16324,6.8,17213,193,59,-943,-708,19.3,1632.4,40,3,1,10,5,13,1,1,0,0,17267,7.0,17921,174,60,943,708,17.4,1726.7
4523452477,0,24,1,1,5,3,6,1,0,1,0,15759,6.8,17563,219,46,338,-1062,21.9,1575.9,39,1,0,3,5,4,0,0,0,0,15421,7.0,18625,220,56,-338,1062,22.0,1542.1
4509989116,0,19,3,1,5,8,6,0,0,0,0,16020,6.8,17044,240,46,-1407,-1305,24.0,1602.0,25,7,0,8,5,12,1,1,0,0,17427,7.2,18349,226,50,1407,1305,22.6,1742.7
4519643155,0,14,1,0,7,11,6,0,0,0,0,16548,6.8,17735,224,51,-2133,-256,22.4,1654.8,16,1,1,11,7,19,1,1,0,0,18681,7.0,17991,215,63,2133,256,21.5,1868.1
4499868617,0,12,4,0,4,10,3,1,1,0,0,14166,6.6,15959,203,41,-4061,-4397,20.3,1416.6,16,2,1,10,4,6,0,0,0,0,18227,7.4,20356,224,72,4061,4397,22.4,1822.7
4524725570,0,26,1,1,7,9,9,1,0,1,0,16682,7.0,18002,180,59,-1370,-1269,18.0,1668.2,15,0,0,9,7,14,1,1,0,0,18052,7.4,19271,221,44,1370,1269,22.1,1805.2
4515606448,0,15,2,0,4,6,7,1,1,0,0,15520,7.0,17369,207,59,-1949,-1983,20.7,1552.0,37,2,1,6,4,10,1,0,1,0,17469,7.2,19352,230,56,1949,1983,23.0,1746.9
4477491383,0,16,3,1,8,7,9,0,0,0,0,16059,7.0,17499,190,36,-1073,-657,19.0,1605.9,18,4,0,7,8,7,1,0,1,0,17132,6.8,18156,232,43,1073,657,23.2,1713.2
4513003533,0,22,3,0,9,10,14,1,1,0,0,16749,6.4,16227,166,48,-2419,-3313,16.6,1674.9,19,1,1,10,9,13,0,0,0,0,19168,7.4,19540,240,39,2419,3313,24.0,1916.8
4512554301,0,15,3,0,4,5,1,1,1,0,0,16755,6.8,18760,263,68,695,1686,26.3,1675.5,17,2,1,5,4,4,0,0,0,0,16060,6.6,17074,225,39,-695,-1686,22.5,1606.0
4521188250,0,40,4,0,6,9,5,0,0,0,0,15499,6.8,17298,222,28,-1937,-1514,22.2,1549.9,13,5,1,9,6,12,1,1,0,0,17436,7.0,18812,204,59,1937,1514,20.4,1743.6
4522281462,0,28,4,0,9,10,10,0,0,0,0,17910,6.8,16867,207,45,88,-589,20.7,1791.0,42,4,1,10,9,11,1,0,1,0,17822,6.8,17456,197,44,-88,589,19.7,1782.2
4454688114,0,17,4,0,2,9,2,0,0,0,0,14366,6.6,16510,221,55,-3046,-1990,22.1,1436.6,21,4,1,9,2,15,1,1,0,0,17412,7.2,18500,222,44,3046,1990,22.2,1741.2
4447699269,0,37,5,0,10,6,18,0,0,0,0,17690,7.2,18278,192,45,1377,2429,19.2,1769.0,16,1,1,6,10,5,0,0,0,0,16313,6.6,15849,194,42,-1377,-2429,19.4,1631.3
4477403514,0,16,2,0,5,9,3,1,1,0,0,15803,7.0,18061,217,73,-2994,-1007,21.7,1580.3,13,1,1,9,5,12,1,0,1,0,18797,7.2,19068,248,67,2994,1007,24.8,1879.7
4513799193,0,14,1,0,2,4,3,1,1,0,0,14318,7.0,17405,207,51,-2928,-110,20.7,1431.8,17,4,1,4,2,10,0,0,0,1,17246,7.0,17515,240,44,2928,110,24.0,1724.6
4514309643,0,16,4,0,5,7,6,0,0,0,0,15337,6.6,16528,198,39,-646,-148,19.8,1533.7,17,3,1,7,5,9,0,0,0,0,15983,6.6,16676,197,36,646,148,19.7,1598.3
4468826145,0,15,2,0,6,9,3,1,1,0,0,15512,6.6,17704,198,50,-2399,-1527,19.8,1551.2,15,1,1,9,6,5,0,0,0,0,17911,7.2,19231,222,48,2399,1527,22.2,1791.1
4510137231,0,15,1,1,1,0,0,1,0,1,0,14712,7.0,17631,253,62,-132,-1473,25.3,1471.2,12,2,0,0,1,0,1,1,0,0,14844,7.0,19104,264,68,132,1473,26.4,1484.4
4467411161,0,18,2,1,9,8,7,1,0,1,1,18490,6.8,16745,215,33,479,-658,21.5,1849.0,15,2,0,8,9,15,1,1,0,0,18011,6.8,17403,230,47,-479,658,23.0,1801.1
4520789246,0,11,0,0,5,10,5,0,0,0,0,14740,6.4,15556,156,49,-4229,-4184,15.6,1474.0,16,3,1,10,5,12,1,1,0,0,18969,7.4,19740,220,64,4229,4184,22.0,1896.9
4500599044,0,89,3,0,7,5,8,1,0,1,0,16269,7.2,18306,202,52,459,1388,20.2,1626.9,16,2,1,5,7,8,1,1,0,0,15810,6.6,16918,212,44,-459,-1388,21.2,1581.0
4511049704,0,14,4,0,4,5,4,0,0,0,0,16295,7.2,18278,261,36,41,-936,26.1,1629.5,56,2,1,5,4,5,1,1,0,0,16254,7.2,19214,234,64,-41,936,23.4,1625.4
4453463831,0,14,3,1,4,6,4,1,1,0,0,16209,7.2,18802,235,72,-907,-1159,23.5,1620.9,17,5,0,6,4,7,0,0,0,0,17116,7.2,19961,242,62,907,1159,24.2,1711.6
4522000980,0,14,0,1,8,8,6,1,1,0,0,16809,7.0,18470,210,44,-12,-151,21.0,1680.9,13,2,0,8,8,6,0,0,0,0,16821,7.2,18621,221,48,12,151,22.1,1682.1
4470286128,0,16,3,0,4,13,5,0,0,0,0,15309,6.6,16938,175,48,-4962,-2312,17.5,1530.9,15,4,1,13,4,14,1,0,1,0,20271,7.2,19250,242,38,4962,2312,24.2,2027.1
4467051072,0,17,3,0,3,9,4,1,0,1,0,15284,7.0,17637,207,72,-3712,-3375,20.7,1528.4,35,6,1,9,3,6,1,1,0,0,18996,7.6,21012,246,61,3712,3375,24.6,1899.6
4495598638,0,21,1,0,3,3,5,0,0,0,0,15480,7.0,19018,243,61,-816,-27,24.3,1548.0,17,6,1,3,3,3,1,1,0,0,16296,7.0,19045,278,63,816,27,27.8,1629.6
4483736284,0,93,4,0,8,8,8,1,0,1,0,18683,7.2,19031,218,52,1874,1408,21.8,1868.3,16,4,1,8,8,8,1,1,0,0,16809,6.8,17623,215,44,-1874,-1408,21.5,1680.9
4508119465,0,15,2,1,11,11,13,0,0,0,0,18575,7.2,18974,198,49,-204,1350,19.8,1857.5,39,2,0,11,11,10,1,1,0,1,18779,6.8,17624,211,36,204,-1350,21.1,1877.9
4452033699,0,17,3,0,7,11,12,0,0,0,0,17131,7.2,18470,242,34,-2550,-1700,24.2,1713.1,14,1,1,11,7,7,0,0,0,1,19681,7.2,20170,258,37,2550,1700,25.8,1968.1
4468744263,0,22,4,0,7,6,11,0,0,0,0,16587,6.8,17801,216,44,-674,909,21.6,1658.7,20,6,1,6,7,8,0,0,0,0,17261,6.6,16892,219,34,674,-909,21.9,1726.1
4523449093,0,26,1,0,6,6,5,2,1,1,0,15539,6.8,17101,191,56,8,572,19.1,1553.9,17,2,1,6,6,8,0,0,0,0,15531,6.4,16529,208,48,-8,-572,20.8,1553.1
4518359137,0,12,1,1,8,8,6,0,0,0,0,16983,7.2,18675,198,52,-125,-479,19.8,1698.3,15,4,0,8,8,7,1,1,0,0,17108,7.4,19154,208,51,125,479,20.8,1710.8
4506537337,0,16,4,1,4,5,3,0,0,0,0,15347,7.0,17655,234,46,-1374,-1041,23.4,1534.7,22,0,0,5,4,7,2,1,1,0,16721,6.8,18696,238,57,1374,1041,23.8,1672.1
4465317385,0,16,3,1,7,13,7,0,0,0,0,15061,6.2,15124,183,31,-4179,-4531,18.3,1506.1,15,3,0,13,7,8,1,0,1,0,19240,7.2,19655,236,52,4179,4531,23.6,1924.0
4490286186,0,17,1,1,10,7,13,1,1,0,0,17545,6.8,17316,179,55,-280,-752,17.9,1754.5,39,3,0,7,10,9,0,0,0,0,17825,6.8,18068,217,61,280,752,21.7,1782.5
4520844282,0,14,0,0,6,9,9,0,0,0,0,16240,7.2,18554,205,68,-2184,-1298,20.5,1624.0,85,1,1,9,6,9,1,1,0,0,18424,7.2,19852,250,56,2184,1298,25.0,1842.4
4489127821,0,15,0,0,4,7,3,1,0,1,0,15798,6.8,17608,225,52,-2289,-2259,22.5,1579.8,16,2,1,7,4,10,1,1,0,0,18087,7.4,19867,239,60,2289,2259,23.9,1808.7
4493176020,0,16,2,1,3,8,2,0,0,0,0,14566,7.0,16999,190,45,-2414,-959,19.0,1456.6,17,4,0,8,3,12,0,0,0,0,16980,6.8,17958,218,45,2414,959,21.8,1698.0
4493167660,0,86,5,0,3,7,3,0,0,0,0,14454,6.6,17394,191,46,-3003,-2118,19.1,1445.4,17,2,1,7,3,5,1,1,0,0,17457,7.4,19512,239,56,3003,2118,23.9,1745.7
4518398383,0,13,2,1,11,4,4,1,1,0,0,18232,7.4,19347,231,55,3987,3310,23.1,1823.2,12,1,0,4,11,3,0,0,0,0,14245,6.4,16037,168,40,-3987,-3310,16.8,1424.5
4523810614,0,16,2,0,5,5,6,1,1,0,0,16253,6.8,18163,212,46,-17,-1171,21.2,1625.3,14,3,1,5,5,2,0,0,0,0,16270,7.2,19334,243,55,17,1171,24.3,1627.0
4488853318,0,11,2,0,2,9,1,0,0,0,0,13380,6.2,14784,188,48,-4446,-3703,18.8,1338.0,18,0,1,9,2,10,1,1,0,0,17826,7.2,18487,233,44,4446,3703,23.3,1782.6
4498675239,0,10,1,0,5,12,7,0,0,0,0,15828,6.6,16976,195,40,-2330,-1189,19.5,1582.8,13,3,1,12,5,12,1,1,0,0,18158,7.0,18165,215,40,2330,1189,21.5,1815.8
4485856450,0,21,3,0,8,8,10,0,0,0,0,17544,7.2,18246,213,53,-375,-547,21.3,1754.4,20,5,1,8,8,9,1,1,0,0,17919,7.0,18793,230,62,375,547,23.0,1791.9
4462358723,0,15,4,1,5,7,2,0,0,0,0,15210,6.4,15974,172,40,-1656,-1832,17.2,1521.0,13,5,0,7,5,3,0,0,0,0,16866,6.8,17806,219,51,1656,1832,21.9,1686.6
4478776750,0,50,4,1,4,4,9,1,1,0,0,15317,6.6,16907,226,52,-1300,-120,22.6,1531.7,18,2,0,4,4,7,1,0,1,1,16617,6.8,17027,211,48,1300,120,21.1,1661.7
4480203372,0,13,2,0,9,4,12,0,0,0,1,19292,6.8,18197,213,49,4062,2332,21.3,1929.2,26,2,1,4,9,6,2,1,1,0,15230,6.4,15865,191,42,-4062,-2332,19.1,1523.0
4463081486,0,12,3,1,7,4,8,0,0,0,0,17653,7.0,18461,231,59,2962,2430,23.1,1765.3,18,1,0,4,7,5,0,0,0,0,14691,6.4,16031,210,31,-2962,-2430,21.0,1469.1
4444894425,0,18,6,0,3,5,4,0,0,0,0,15144,7.4,18640,214,56,-439,775,21.4,1514.4,17,2,1,5,3,6,2,1,1,0,15583,6.6,17865,241,32,439,-775,24.1,1558.3
4521632835,0,13,5,0,7,7,7,1,1,0,0,16635,7.0,17795,215,62,544,758,21.5,1663.5,33,1,1,7,7,10,0,0,0,0,16091,6.6,17037,194,49,-544,-758,19.4,1609.1
4437927077,0,198,1,1,6,9,6,0,0,0,0,16585,7.0,18342,231,55,-991,-844,23.1,1658.5,12,1,0,9,6,7,0,0,0,0,17576,7.4,19186,223,40,991,844,22.3,1757.6
4515427154,0,15,0,0,6,9,6,0,0,0,0,18187,7.0,18454,223,55,299,-1051,22.3,1818.7,13,1,1,9,6,7,1,0,1,0,17888,7.2,19505,215,60,-299,1051,21.5,1788.8
4473558954,0,16,1,0,5,5,3,0,0,0,0,15153,7.2,18629,191,51,-809,411,19.1,1515.3,15,1,1,5,5,5,1,1,0,0,15962,7.0,18218,216,44,809,-411,21.6,1596.2
4521354990,0,10,0,0,7,9,4,0,0,0,0,15933,6.8,16916,221,48,-1790,-1980,22.1,1593.3,14,3,1,9,7,10,1,1,0,0,17723,7.2,18896,223,64,1790,1980,22.3,1772.3
4448333307,0,14,3,1,3,10,4,0,0,0,0,14674,6.4,15727,184,48,-5092,-4196,18.4,1467.4,38,3,0,10,3,5,0,0,0,1,19766,7.4,19923,240,48,5092,4196,24.0,1976.6
4523348814,0,18,3,1,7,3,6,1,0,1,0,16300,7.0,18376,226,47,286,-12,22.6,1630.0,16,7,0,3,7,2,1,1,0,0,16014,6.8,18388,239,56,-286,12,23.9,1601.4
4515841164,0,18,2,0,5,6,6,1,1,0,0,15167,7.0,17584,200,52,-1315,-1049,20.0,1516.7,45,4,1,6,5,8,0,0,0,0,16482,7.0,18633,222,46,1315,1049,22.2,1648.2
4482490476,0,21,1,0,7,5,6,2,1,1,0,16158,6.8,17789,224,46,1184,1807,22.4,1615.8,49,3,1,5,7,3,0,0,0,0,14974,6.6,15982,177,55,-1184,-1807,17.7,1497.4
4458474426,0,15,0,1,7,12,5,2,1,1,0,16074,6.8,16408,185,50,-3268,-4457,18.5,1607.4,17,3,0,12,7,10,0,0,0,0,19342,7.6,20865,206,55,3268,4457,20.6,1934.2
4497696872,0,15,3,0,6,4,6,0,0,0,0,15807,6.8,17244,221,33,239,1281,22.1,1580.7,16,2,1,4,6,3,1,1,0,0,15568,6.6,15963,213,44,-239,-1281,21.3,1556.8
4526576560,0,18,5,0,4,8,6,1,1,0,0,15589,7.0,18306,219,64,-2268,-1810,21.9,1558.9,31,6,1,8,4,8,0,0,0,0,17857,7.4,20116,261,58,2268,1810,26.1,1785.7
4518358306,0,42,4,0,6,11,10,1,1,0,0,16245,7.0,18044,208,50,-3451,-2220,20.8,1624.5,26,5,1,11,6,10,1,0,1,0,19696,7.6,20264,235,59,3451,2220,23.5,1969.6
4502917237,0,13,2,1,12,5,11,0,0,0,0,18982,7.0,18664,234,48,2741,2415,23.4,1898.2,14,1,0,5,12,5,0,0,0,0,16241,6.6,16249,205,48,-2741,-2415,20.5,1624.1
4465402060,0,14,1,0,7,5,10,0,0,0,0,16509,7.0,18241,202,52,373,-1568,20.2,1650.9,14,2,1,5,7,2,1,1,0,0,16136,7.2,19809,224,76,-373,1568,22.4,1613.6
4525849637,1,16,1,0,5,11,5,0,0,0,0,15871,6.6,16394,200,56,-3162,-23,20.0,1587.1,15,8,1,11,5,15,0,0,0,1,19033,6.4,16417,195,36,3162,23,19.5,1903.3
4524702479,1,15,3,1,5,2,6,1,1,0,0,16225,6.8,17742,231,56,2430,2023,23.1,1622.5,16,1,0,2,5,2,0,0,0,0,13795,6.6,15719,179,52,-2430,-2023,17.9,1379.5
4501004124,1,18,2,1,8,2,9,1,0,1,1,18188,7.0,18675,208,49,3263,1440,20.8,1818.8,16,3,0,2,8,2,1,1,0,0,14925,6.8,17235,200,68,-3263,-1440,20.0,1492.5
4511615760,1,22,2,0,6,3,10,0,0,0,0,17141,7.2,19142,232,54,2378,2190,23.2,1714.1,15,2,1,3,6,1,1,1,0,0,14763,6.8,16952,206,56,-2378,-2190,20.6,1476.3
4524685045,1,12,3,0,8,6,9,1,1,0,0,16738,7.2,19296,214,60,624,1208,21.4,1673.8,14,0,1,6,8,3,0,0,0,0,16114,7.0,18088,225,33,-624,-1208,22.5,1611.4
4452292260,1,37,1,0,9,11,8,1,1,0,0,17060,6.6,17118,179,36,-896,-661,17.9,1706.0,16,15,1,11,9,14,0,0,0,0,17956,7.0,17779,200,52,896,661,20.0,1795.6
4524407688,1,18,1,1,2,1,2,1,1,0,0,15649,7.0,18530,269,56,1281,1111,26.9,1564.9,13,2,0,1,2,0,0,0,0,0,14368,7.0,17419,225,62,-1281,-1111,22.5,1436.8
4524888119,1,12,3,0,4,5,3,1,1,0,0,15131,6.8,17618,223,44,-735,46,22.3,1513.1,17,2,1,5,4,5,0,0,0,0,15866,7.0,17572,221,55,735,-46,22.1,1586.6
4452015662,1,12,2,1,3,5,5,2,1,1,0,15188,6.8,17576,221,48,-888,-975,22.1,1518.8,16,3,0,5,3,5,0,0,0,0,16076,7.0,18551,192,59,888,975,19.2,1607.6
4506462868,1,23,3,0,4,6,5,0,0,0,0,15364,7.0,18063,210,51,-946,630,21.0,1536.4,19,4,1,6,4,8,1,1,0,0,16310,6.8,17433,229,40,946,-630,22.9,1631.0
4518185070,1,52,3,0,8,5,13,2,1,1,0,18398,7.0,19201,234,71,2087,650,23.4,1839.8,15,2,1,5,8,3,0,0,0,0,16311,7.0,18551,226,56,-2087,-650,22.6,1631.1
4525545485,1,14,1,1,9,7,9,0,0,0,0,18880,7.0,19278,235,54,2690,2514,23.5,1888.0,17,2,0,7,9,9,1,1,0,0,16190,6.6,16764,193,43,-2690,-2514,19.3,1619.0
4475134384,1,31,1,1,2,3,2,0,0,0,0,15705,6.6,17630,230,57,856,-268,23.0,1570.5,134,2,0,3,2,6,1,1,0,0,14849,7.0,17898,219,56,-856,268,21.9,1484.9
4500504137,1,23,0,1,13,4,17,1,1,0,1,20028,7.0,18736,213,43,4887,2100,21.3,2002.8,16,5,0,4,13,2,0,0,0,0,15141,6.6,16636,207,56,-4887,-2100,20.7,1514.1
4489690611,1,15,6,1,10,5,14,1,0,1,0,17857,6.8,17155,211,38,1879,-344,21.1,1785.7,16,4,0,5,10,5,0,0,0,0,15978,6.8,17499,227,34,-1879,344,22.7,1597.8
4519645967,1,15,0,1,7,6,9,0,0,0,0,17537,7.0,18384,232,44,1752,830,23.2,1753.7,27,3,0,6,7,4,1,1,0,0,15785,6.8,17554,201,56,-1752,-830,20.1,1578.5
4525865804,1,13,6,1,8,8,7,1,1,0,0,16613,6.8,17888,229,44,-271,99,22.9,1661.3,15,4,0,8,8,4,0,0,0,0,16884,6.8,17789,232,44,271,-99,23.2,1688.4
4509242024,1,40,2,0,6,4,4,0,0,0,0,16085,7.4,19076,204,56,275,872,20.4,1608.5,15,1,1,4,6,5,1,1,0,0,15810,7.2,18204,223,62,-275,-872,22.3,1581.0
4516073213,1,10,1,1,8,7,5,1,1,0,0,17325,7.0,19648,246,55,744,1657,24.6,1732.5,15,0,0,7,8,6,1,0,1,0,16581,6.8,17991,216,36,-744,-1657,21.6,1658.1
4512064032,1,13,2,0,4,4,5,0,0,0,0,15198,7.0,18486,205,60,-266,15,20.5,1519.8,15,5,1,4,4,2,1,1,0,0,15464,7.0,18471,224,57,266,-15,22.4,1546.4
4525129599,1,16,3,1,9,7,10,0,0,0,0,18064,7.2,19192,252,45,2321,1274,25.2,1806.4,18,2,0,7,9,5,1,1,0,0,15743,6.8,17918,198,41,-2321,-1274,19.8,1574.3
4526791420,1,18,2,0,3,3,3,1,0,1,1,16748,7.0,17820,221,64,2533,1524,22.1,1674.8,38,1,1,3,3,4,1,1,0,0,14215,6.4,16296,198,44,-2533,-1524,19.8,1421.5
4525326887,1,40,4,1,9,6,16,0,0,0,0,17348,6.6,16417,191,40,1528,-104,19.1,1734.8,14,4,0,6,9,7,1,1,0,0,15820,6.6,16521,191,55,-1528,104,19.1,1582.0
4523303530,1,18,3,1,14,5,12,1,1,0,0,20294,6.8,18459,230,48,5805,4777,23.0,2029.4,17,1,0,5,14,6,0,0,0,0,14489,5.8,13682,178,28,-5805,-4777,17.8,1448.9
4432850060,1,19,3,1,9,6,11,0,0,0,0,17561,7.0,19152,207,68,2134,1500,20.7,1756.1,15,4,0,6,9,2,1,1,0,0,15427,7.0,17652,204,48,-2134,-1500,20.4,1542.7
4463528314,1,17,1,0,9,6,12,0,0,0,0,17752,7.0,18405,212,47,1512,447,21.2,1775.2,12,6,1,6,9,6,1,1,0,0,16240,7.0,17958,219,52,-1512,-447,21.9,1624.0
4524182340,1,19,4,1,6,4,3,1,0,1,0,16561,7.0,17961,232,53,1496,-730,23.2,1656.1,55,6,0,4,6,4,1,1,0,0,15065,7.0,18691,191,55,-1496,730,19.1,1506.5
4500634961,1,35,3,1,14,3,20,1,1,0,0,20028,7.4,20153,229,51,5885,4694,22.9,2002.8,22,1,0,3,14,3,0,0,0,0,14143,6.2,15459,160,60,-5885,-4694,16.0,1414.3
4524504083,1,38,4,1,8,5,9,1,1,0,0,16646,7.0,17451,188,51,1308,1296,18.8,1664.6,16,1,0,5,8,7,1,0,1,0,15338,6.4,16155,227,40,-1308,-1296,22.7,1533.8
4520755410,1,18,1,0,9,6,10,1,0,1,0,17512,7.0,18140,186,51,2549,1269,18.6,1751.2,17,0,1,6,9,6,1,1,0,0,14963,6.6,16871,174,41,-2549,-1269,17.4,1496.3
4527260532,1,18,5,0,10,6,17,0,0,0,0,16982,6.8,17597,187,46,1093,770,18.7,1698.2,18,1,1,6,10,4,0,0,0,0,15889,6.6,16827,222,44,-1093,-770,22.2,1588.9
4520303900,1,14,1,0,5,3,5,1,0,1,1,17531,7.4,19484,241,46,2351,1317,24.1,1753.1,12,2,1,3,5,3,1,1,0,0,15180,7.0,18167,223,44,-2351,-1317,22.3,1518.0
4459773045,1,22,5,1,11,7,14,1,1,0,1,19465,7.0,17819,214,52,4013,2137,21.4,1946.5,14,1,0,7,11,8,0,0,0,0,15452,6.4,15682,182,29,-4013,-2137,18.2,1545.2
4472995795,1,11,2,1,5,3,7,0,0,0,0,17264,7.0,18301,248,44,3037,2561,24.8,1726.4,26,0,0,3,5,2,0,0,0,0,14227,6.4,15740,174,60,-3037,-2561,17.4,1422.7
4491194203,1,24,3,0,10,5,15,0,0,0,0,17688,7.2,19492,197,48,1937,2816,19.7,1768.8,49,2,1,5,10,4,0,0,0,0,15751,6.8,16676,192,44,-1937,-2816,19.2,1575.1
4501993937,1,59,3,1,12,5,19,1,1,0,0,19607,7.6,19804,221,44,3913,2948,22.1,1960.7,17,2,0,5,12,7,0,0,0,0,15694,6.6,16856,220,52,-3913,-2948,22.0,1569.4
4440143794,1,48,5,0,6,3,8,1,1,0,0,17612,7.6,19905,246,68,2356,2431,24.6,1761.2,19,1,1,3,6,2,0,0,0,0,15256,7.0,17474,213,55,-2356,-2431,21.3,1525.6
4456330802,1,21,2,0,7,6,3,1,0,1,0,16653,7.4,19603,229,72,140,1737,22.9,1665.3,130,1,1,6,7,5,0,0,0,0,16513,7.0,17866,229,31,-140,-1737,22.9,1651.3
4498040102,1,21,1,1,13,4,14,1,1,0,0,18722,6.8,18343,187,46,3593,727,18.7,1872.2,33,5,0,4,13,6,0,0,0,0,15129,6.8,17616,209,49,-3593,-727,20.9,1512.9
4497457937,1,41,3,1,4,8,4,0,0,0,0,16059,7.0,18190,221,41,-1521,-2185,22.1,1605.9,19,24,0,8,4,14,1,1,0,0,17580,7.4,20375,246,50,1521,2185,24.6,1758.0
4449098612,1,13,2,1,10,6,12,1,1,0,0,18516,7.0,19255,240,58,2019,674,24.0,1851.6,105,1,0,6,10,8,0,0,0,0,16497,7.2,18581,214,49,-2019,-674,21.4,1649.7
4520047610,1,16,2,0,6,6,7,0,0,0,0,16138,6.8,17204,211,31,-243,418,21.1,1613.8,11,3,1,6,6,13,1,0,1,0,16381,6.6,16786,188,52,243,-418,18.8,1638.1
4498547016,1,85,3,1,13,4,13,1,1,0,0,18962,7.6,20021,207,48,3833,2849,20.7,1896.2,20,2,0,4,13,3,1,0,1,0,15129,6.8,17172,203,43,-3833,-2849,20.3,1512.9
4527110786,1,47,1,0,3,2,3,0,0,0,0,14706,6.6,15747,203,45,207,-1880,20.3,1470.6,18,2,1,2,3,1,0,0,0,0,14499,6.8,17627,242,54,-207,1880,24.2,1449.9
4527661727,1,20,7,0,6,6,3,1,1,0,0,16662,7.0,18914,237,48,619,35,23.7,1666.2,21,4,1,6,6,7,0,0,0,0,16043,7.2,18879,212,48,-619,-35,21.2,1604.3
4520635359,1,16,1,1,7,17,8,1,0,1,0,16239,6.4,16109,202,52,-4876,-3481,20.2,1623.9,17,3,0,17,7,19,1,1,0,0,21115,7.2,19590,230,56,4876,3481,23.0,2111.5
4518442366,1,13,5,0,6,4,3,1,1,0,0,16409,6.8,18420,232,43,596,486,23.2,1640.9,13,1,1,4,6,4,0,0,0,0,15813,7.0,17934,202,68,-596,-486,20.2,1581.3
4475217801,1,21,3,1,5,2,4,0,0,0,0,16350,7.0,18701,245,53,1290,1337,24.5,1635.0,37,6,0,2,5,2,0,0,0,0,15060,6.8,17364,236,54,-1290,-1337,23.6,1506.0
4523545639,1,18,1,1,9,8,15,0,0,0,0,18809,7.0,18415,225,39,2309,1211,22.5,1880.9,15,1,0,8,9,8,1,1,0,0,16500,7.0,17204,185,55,-2309,-1211,18.5,1650.0
4522454983,1,18,2,1,6,6,5,2,1,1,0,16604,7.0,17994,240,56,867,420,24.0,1660.4,16,4,0,6,6,3,0,0,0,0,15737,6.8,17574,205,40,-867,-420,20.5,1573.7
4509271270,1,12,1,0,3,8,6,1,1,0,0,15159,6.6,17161,221,65,-2341,-2034,22.1,1515.9,15,1,1,8,3,12,0,0,0,0,17500,7.2,19195,214,63,2341,2034,21.4,1750.0
4460036381,1,13,1,0,3,7,3,1,1,0,0,14659,6.2,15944,193,48,-944,-2050,19.3,1465.9,13,1,1,7,3,6,0,0,0,0,15603,6.8,17994,213,48,944,2050,21.3,1560.3
4524489570,1,15,1,1,8,5,8,0,0,0,0,17603,7.0,18424,224,60,1835,1172,22.4,1760.3,19,1,0,5,8,7,2,1,1,0,15768,6.8,17252,186,60,-1835,-1172,18.6,1576.8
4524597902,1,15,1,1,10,9,13,1,1,0,0,18217,6.6,16663,190,44,1674,-648,19.0,1821.7,17,2,0,9,10,7,0,0,0,0,16543,7.0,17311,192,36,-1674,648,19.2,1654.3
4524992548,1,18,1,0,7,8,8,1,1,0,0,17570,7.0,18283,238,58,527,1493,23.8,1757.0,16,2,1,8,7,11,0,0,0,0,17043,6.8,16790,176,48,-527,-1493,17.6,1704.3
4427379345,1,15,5,1,10,1,9,1,1,0,0,19225,7.4,20071,253,43,4947,2051,25.3,1922.5,16,2,0,1,10,1,1,0,1,0,14278,6.8,18020,200,49,-4947,-2051,20.0,1427.8
4526817312,1,16,1,1,4,3,5,0,0,0,0,16425,7.0,17611,227,44,2167,538,22.7,1642.5,16,1,0,3,4,4,1,1,0,0,14258,6.8,17073,208,46,-2167,-538,20.8,1425.8
4516517025,1,36,2,1,7,5,4,0,0,0,0,17301,7.8,20766,241,67,1207,2244,24.1,1730.1,11,1,0,5,7,4,0,0,0,0,16094,7.0,18522,243,52,-1207,-2244,24.3,1609.4
4494818670,1,13,7,1,6,5,8,1,1,0,0,16283,7.0,18397,228,44,-152,71,22.8,1628.3,19,1,0,5,6,8,0,0,0,0,16435,6.8,18326,253,40,152,-71,25.3,1643.5
4431218839,1,13,3,1,6,4,6,1,1,0,0,17089,7.2,18072,232,52,2387,1690,23.2,1708.9,33,1,0,4,6,3,0,0,0,0,14702,6.6,16382,191,44,-2387,-1690,19.1,1470.2
4517015396,1,16,5,1,6,6,10,0,0,0,0,16992,6.8,17775,227,53,1182,420,22.7,1699.2,20,2,0,6,6,8,0,0,0,0,15810,6.6,17355,203,39,-1182,-420,20.3,1581.0
4521033474,1,17,5,0,3,6,4,1,1,0,0,14513,6.8,16872,202,52,-1494,-368,20.2,1451.3,18,3,1,6,3,5,0,0,0,0,16007,6.8,17240,232,51,1494,368,23.2,1600.7
4470312208,1,16,4,0,10,6,14,0,0,0,0,17769,7.2,18832,207,44,1417,1116,20.7,1776.9,14,4,1,6,10,3,1,1,0,0,16352,7.0,17716,215,58,-1417,-1116,21.5,1635.2
4527780032,1,16,3,0,1,2,0,1,1,0,0,14603,7.0,18478,232,71,670,1446,23.2,1460.3,38,3,1,2,1,5,0,0,0,0,13933,6.8,17032,197,52,-670,-1446,19.7,1393.3
4519052446,1,36,7,1,10,6,11,2,1,1,0,18132,7.6,19522,232,47,1722,1514,23.2,1813.2,20,5,0,6,10,8,0,0,0,0,16410,7.2,18008,211,44,-1722,-1514,21.1,1641.0
4526484364,1,19,2,1,10,5,11,1,1,0,0,18436,7.0,18039,209,47,1990,-86,20.9,1843.6,16,4,0,5,10,4,1,0,1,0,16446,6.8,18125,226,48,-1990,86,22.6,1644.6
4492568558,1,17,1,1,10,4,11,0,0,0,0,17464,7.0,18187,217,35,1579,-171,21.7,1746.4,11,3,0,4,10,5,1,1,0,0,15885,6.8,18358,205,68,-1579,171,20.5,1588.5
4452298627,1,14,4,1,15,4,19,1,1,0,0,21314,7.2,19360,245,32,6950,3536,24.5,2131.4,15,2,0,4,15,2,0,0,0,0,14364,6.4,15824,193,37,-6950,-3536,19.3,1436.4
4524662465,1,16,1,0,11,4,18,1,1,0,0,19695,7.2,19512,258,48,3936,2111,25.8,1969.5,12,2,1,4,11,4,1,0,1,0,15759,7.0,17401,205,68,-3936,-2111,20.5,1575.9
4455643326,1,15,2,0,5,3,4,1,1,0,0,16093,7.2,19191,245,49,517,222,24.5,1609.3,14,4,1,3,5,1,0,0,0,0,15576,7.0,18969,213,78,-517,-222,21.3,1557.6
4517481803,1,15,3,1,7,5,8,0,0,0,0,17134,7.0,19465,207,60,408,742,20.7,1713.4,16,2,0,5,7,4,1,1,0,0,16726,7.2,18723,236,56,-408,-742,23.6,1672.6
4461974957,1,34,1,0,5,10,5,0,0,0,0,16297,7.2,19135,212,66,-2523,-1057,21.2,1629.7,15,1,1,10,5,10,0,0,0,0,18820,7.4,20192,236,60,2523,1057,23.6,1882.0
4509069463,1,15,3,1,7,5,8,2,1,1,0,17788,7.0,18965,248,53,1767,1408,24.8,1778.8,11,1,0,5,7,4,0,0,0,0,16021,7.0,17557,221,56,-1767,-1408,22.1,1602.1
4494170863,1,17,1,0,3,5,1,1,1,0,0,14900,6.8,18274,211,68,-2631,-1358,21.1,1490.0,16,3,1,5,3,11,0,0,0,0,17531,7.4,19632,221,78,2631,1358,22.1,1753.1
4440743974,1,15,2,1,11,10,9,2,1,1,0,18504,7.4,19524,226,40,1011,480,22.6,1850.4,17,2,0,10,11,12,0,0,0,0,17493,7.2,19044,187,52,-1011,-480,18.7,1749.3
4525312884,1,16,2,1,7,3,7,1,1,0,0,17639,7.2,18319,247,47,2392,1200,24.7,1763.9,14,4,0,3,7,3,0,0,0,0,15247,6.8,17119,214,48,-2392,-1200,21.4,1524.7
4523531334,1,14,2,1,11,8,18,0,0,0,0,19275,7.2,18899,233,58,2711,1931,23.3,1927.5,16,2,0,8,11,15,1,1,0,0,16564,6.8,16968,183,48,-2711,-1931,18.3,1656.4
4417418392,1,18,2,1,14,2,14,1,1,0,0,19185,7.0,18543,196,48,5794,3899,19.6,1918.5,16,4,0,2,14,1,0,0,0,0,13391,6.0,14644,166,46,-5794,-3899,16.6,1339.1
4499790153,1,13,5,1,5,7,7,0,0,0,0,15861,6.8,17523,182,60,-1340,-228,18.2,1586.1,15,3,0,7,5,7,2,1,1,0,17201,6.8,17751,204,56,1340,228,20.4,1720.1
4505017372,1,11,4,1,13,7,10,1,1,0,3,22228,7.2,18219,234,54,8657,7609,23.4,2222.8,11,1,0,7,13,9,0,0,0,0,13571,4.8,10610,107,29,-8657,-7609,10.7,1357.1
4526554592,1,13,5,0,4,10,8,0,0,0,0,14629,6.8,16283,183,52,-3259,-1518,18.3,1462.9,18,0,1,10,4,16,2,1,1,0,17888,7.0,17801,210,40,3259,1518,21.0,1788.8
4519226800,1,22,3,0,10,4,10,1,1,0,0,17354,7.0,18530,217,57,1743,2124,21.7,1735.4,16,2,1,4,10,4,0,0,0,0,15611,6.8,16406,236,56,-1743,-2124,23.6,1561.1
4482256172,1,23,1,0,3,7,3,0,0,0,0,15277,6.8,17286,234,52,-2105,-88,23.4,1527.7,18,4,1,7,3,15,1,1,0,0,17382,7.0,17374,191,54,2105,88,19.1,1738.2
4527516350,1,25,2,1,6,7,6,0,0,0,0,16246,7.0,17593,193,45,-766,-577,19.3,1624.6,15,3,0,7,6,9,1,1,0,0,17012,7.2,18170,204,61,766,577,20.4,1701.2
4459208674,1,19,3,0,3,4,1,1,1,0,0,15056,6.8,18397,225,51,-278,571,22.5,1505.6,15,2,1,4,3,7,0,0,0,0,15334,6.8,17826,208,59,278,-571,20.8,1533.4
4521189222,1,37,4,1,14,7,15,0,0,0,0,21699,7.6,20734,242,43,5773,3643,24.2,2169.9,16,13,0,7,14,6,1,1,0,0,15926,6.8,17091,208,50,-5773,-3643,20.8,1592.6
4513377157,1,16,8,0,4,7,7,1,0,1,0,15726,7.2,17885,222,60,-1614,-418,22.2,1572.6,20,5,1,7,4,9,1,1,0,0,17340,7.0,18303,239,56,1614,418,23.9,1734.0
4510761424,1,20,2,1,7,8,8,2,1,1,0,17606,6.8,17803,227,58,290,477,22.7,1760.6,18,5,0,8,7,13,0,0,0,0,17316,6.6,17326,232,37,-290,-477,23.2,1731.6
4448316334,1,39,3,0,13,8,22,0,0,0,0,18721,7.4,18774,164,44,1721,1678,16.4,1872.1,13,2,1,8,13,9,2,1,1,0,17000,6.8,17096,195,43,-1721,-1678,19.5,1700.0
4525058133,1,13,6,0,12,8,17,1,1,0,0,19198,6.6,17559,199,46,3024,2225,19.9,1919.8,50,2,1,8,12,15,0,0,0,0,16174,6.4,15334,176,34,-3024,-2225,17.6,1617.4
4523582436,1,16,1,0,5,2,6,0,0,0,0,15556,7.0,17886,219,44,1300,1228,21.9,1555.6,16,3,1,2,5,3,0,0,0,0,14256,6.6,16658,218,44,-1300,-1228,21.8,1425.6
4499542309,1,11,2,0,4,7,3,0,0,0,0,15562,6.8,17869,225,48,-435,-427,22.5,1556.2,15,2,1,7,4,8,1,1,0,0,15997,7.0,18296,196,65,435,427,19.6,1599.7
4524908921,1,14,1,1,7,10,4,0,0,0,0,16663,6.8,17192,214,55,-1514,-1142,21.4,1666.3,14,1,0,10,7,19,1,1,0,0,18177,7.0,18334,217,39,1514,1142,21.7,1817.7
4521611697,1,34,3,1,9,8,6,0,0,0,0,17532,7.2,18592,233,44,1068,1295,23.3,1753.2,14,4,0,8,9,10,0,0,0,0,16464,6.8,17297,200,39,-1068,-1295,20.0,1646.4
4520650769,1,18,2,0,4,3,3,0,0,0,0,15220,6.8,18562,234,44,-1297,-129,23.4,1522.0,34,1,1,3,4,4,0,0,0,0,16517,7.0,18691,241,56,1297,129,24.1,1651.7
4489939324,1,17,4,0,4,12,4,1,0,1,1,16643,6.6,15836,202,51,-1111,-1185,20.2,1664.3,15,3,1,12,4,15,1,1,0,1,17754,6.4,17021,188,40,1111,1185,18.8,1775.4
4507366175,1,17,1,1,4,4,3,1,1,0,0,15239,7.2,18213,222,49,-251,231,22.2,1523.9,15,3,0,4,4,6,1,0,1,0,15490,6.8,17982,213,55,251,-231,21.3,1549.0
4489876149,1,48,1,1,7,9,7,1,1,0,0,16765,7.2,18366,213,57,-923,-229,21.3,1676.5,11,0,0,9,7,8,0,0,0,0,17688,7.0,18595,214,38,923,229,21.4,1768.8
4504045676,1,16,8,0,6,3,4,1,0,1,0,16443,7.4,19348,261,51,1030,914,26.1,1644.3,42,5,1,3,6,5,1,1,0,0,15413,7.0,18434,235,47,-1030,-914,23.5,1541.3
4486550579,1,19,1,1,13,5,13,1,1,0,1,21132,7.6,19941,217,56,6289,3996,21.7,2113.2,15,3,0,5,13,6,0,0,0,0,14843,6.4,15945,179,32,-6289,-3996,17.9,1484.3
4516180818,1,20,1,1,5,6,6,1,1,0,0,16035,6.8,16853,190,63,-608,-703,19.0,1603.5,47,6,0,6,5,8,0,0,0,0,16643,6.8,17556,210,48,608,703,21.0,1664.3
4447992971,1,16,2,1,6,4,10,1,1,0,0,16993,7.2,18935,262,57,422,-758,26.2,1699.3,16,3,0,4,6,6,0,0,0,0,16571,7.4,19693,254,60,-422,758,25.4,1657.1
4515497599,1,17,4,1,14,3,16,0,0,0,0,20139,7.8,21898,218,56,5035,5420,21.8,2013.9,16,1,0,3,14,5,0,0,0,0,15104,6.6,16478,223,40,-5035,-5420,22.3,1510.4
4506803451,1,16,4,1,11,2,8,1,1,0,0,19038,7.4,20256,252,46,4090,2523,25.2,1903.8,14,3,0,2,11,3,0,0,0,0,14948,7.0,17733,214,68,-4090,-2523,21.4,1494.8
4514842699,1,16,2,1,6,0,6,1,1,0,0,15318,7.0,17999,191,58,1125,299,19.1,1531.8,17,1,0,0,6,0,0,0,0,0,14193,7.0,17700,251,40,-1125,-299,25.1,1419.3
4452674976,1,18,2,0,4,7,6,1,0,1,0,15536,6.6,16788,234,48,-1972,-1064,23.4,1553.6,19,6,1,7,4,14,1,1,0,0,17508,7.0,17852,223,58,1972,1064,22.3,1750.8
4522587256,1,15,3,0,4,11,3,0,0,0,0,14927,6.4,16195,195,44,-2597,-1718,19.5,1492.7,20,3,1,11,4,10,1,1,0,0,17524,7.0,17913,221,46,2597,1718,22.1,1752.4
4522493624,1,17,1,1,7,6,6,1,1,0,0,16737,7.2,18903,240,48,1411,1163,24.0,1673.7,14,2,0,6,7,3,0,0,0,0,15326,7.0,17740,177,49,-1411,-1163,17.7,1532.6
4521429241,1,30,2,1,5,8,6,1,1,0,0,16131,7.0,17821,206,55,-1142,229,20.6,1613.1,17,1,0,8,5,6,1,0,1,0,17273,6.8,17592,221,52,1142,-229,22.1,1727.3
4492671924,1,20,2,1,6,4,5,1,1,0,0,16229,7.2,18988,200,62,164,486,20.0,1622.9,15,3,0,4,6,4,0,0,0,0,16065,7.2,18502,230,54,-164,-486,23.0,1606.5
4499811143,1,15,0,1,9,3,9,0,0,0,1,20026,7.2,19142,246,51,6773,5215,24.6,2002.6,82,2,0,3,9,4,1,1,0,0,13253,6.2,13927,148,32,-6773,-5215,14.8,1325.3
4518677931,1,18,2,1,13,7,12,1,1,0,0,19558,7.0,19133,215,44,3257,1407,21.5,1955.8,15,2,0,7,13,5,0,0,0,0,16301,6.8,17726,203,66,-3257,-1407,20.3,1630.1
4470749064,1,16,1,0,6,7,6,0,0,0,0,16881,7.0,18851,228,56,-216,301,22.8,1688.1,13,2,1,7,6,6,0,0,0,0,17097,7.0,18550,233,44,216,-301,23.3,1709.7
4514527472,1,13,5,0,13,3,11,1,0,1,0,19133,7.4,20110,223,40,4238,3475,22.3,1913.3,14,0,1,3,13,2,1,1,0,0,14895,6.6,16635,168,80,-4238,-3475,16.8,1489.5
4442091575,1,20,3,1,11,1,13,1,1,0,1,18789,7.4,20433,231,38,4250,3916,23.1,1878.9,17,0,0,1,11,1,0,0,0,0,14539,6.4,16517,223,57,-4250,-3916,22.3,1453.9
4525996242,1,34,6,0,4,11,7,0,0,0,0,15790,6.8,17533,208,47,-2878,-1184,20.8,1579.0,24,10,1,11,4,13,0,0,0,0,18668,7.0,18717,234,44,2878,1184,23.4,1866.8
4520633128,1,16,1,0,11,8,13,1,0,1,0,18625,6.6,17323,190,45,1430,916,19.0,1862.5,14,4,1,8,11,9,1,1,0,0,17195,6.6,16407,215,54,-1430,-916,21.5,1719.5
4511649703,1,62,2,1,6,1,8,2,1,1,0,16601,7.0,18535,231,44,1799,442,23.1,1660.1,15,0,0,1,6,1,0,0,0,0,14802,6.8,18093,231,72,-1799,-442,23.1,1480.2
4524290277,1,26,2,1,7,7,5,1,1,0,0,17400,7.4,19175,239,64,567,-8,23.9,1740.0,67,0,0,7,7,10,0,0,0,0,16833,7.2,19183,237,56,-567,8,23.7,1683.3
4463341783,1,17,4,0,7,2,6,1,1,0,0,17616,7.0,18140,243,54,2590,1018,24.3,1761.6,19,4,1,2,7,4,1,0,1,0,15026,6.6,17122,248,46,-2590,-1018,24.8,1502.6
4521641532,1,12,4,1,6,6,3,0,0,0,0,16701,6.8,17820,237,40,882,450,23.7,1670.1,18,2,0,6,6,5,0,0,0,0,15819,6.8,17370,192,56,-882,-450,19.2,1581.9
4527400475,1,14,2,1,6,5,5,1,1,0,0,17375,7.0,17881,225,55,1825,243,22.5,1737.5,50,4,0,5,6,8,0,0,0,0,15550,7.0,17638,199,44,-1825,-243,19.9,1555.0
4519543034,1,50,2,1,8,6,7,0,0,0,0,17628,7.0,18881,233,69,1458,1753,23.3,1762.8,17,0,0,6,8,5,1,1,0,0,16170,7.0,17128,196,66,-1458,-1753,19.6,1617.0
4471981120,1,14,2,1,12,6,11,0,0,0,0,18002,7.0,19391,199,36,2621,2483,19.9,1800.2,12,0,0,6,12,5,0,0,0,0,15381,6.8,16908,195,44,-2621,-2483,19.5,1538.1
4500333234,1,34,3,1,5,3,5,2,1,1,0,17018,7.4,20337,262,60,1496,1664,26.2,1701.8,16,2,0,3,5,2,0,0,0,0,15522,7.2,18673,253,59,-1496,-1664,25.3,1552.2
4412240530,1,34,2,1,9,3,6,0,0,0,0,17484,7.4,20325,230,50,1128,858,23.0,1748.4,15,3,0,3,9,2,1,1,0,0,16356,7.4,19467,226,80,-1128,-858,22.6,1635.6
4513110398,1,19,1,0,5,6,3,1,1,0,0,14820,6.4,16224,167,47,-1671,-1100,16.7,1482.0,17,4,1,6,5,10,0,0,0,0,16491,6.8,17324,223,52,1671,1100,22.3,1649.1
4527208167,1,87,2,1,7,10,5,1,1,0,0,16969,7.0,18900,198,52,-877,418,19.8,1696.9,48,1,0,10,7,11,0,0,0,0,17846,7.2,18482,229,34,877,-418,22.9,1784.6
4482132906,1,17,5,1,9,3,7,0,0,0,0,16646,7.0,18209,236,32,2522,2156,23.6,1664.6,21,5,0,3,9,3,1,1,0,0,14124,6.6,16053,210,43,-2522,-2156,21.0,1412.4
4493892937,1,45,4,0,2,8,1,2,1,1,0,14194,6.8,17765,192,62,-1949,-18,19.2,1419.4,19,3,1,8,2,9,0,0,0,0,16143,7.0,17783,190,53,1949,18,19.0,1614.3
4523021460,1,15,3,1,3,1,3,0,0,0,0,16956,7.0,18863,270,55,3560,2311,27.0,1695.6,45,2,0,1,3,0,0,0,0,0,13396,6.6,16552,198,51,-3560,-2311,19.8,1339.6
4510559226,1,17,3,0,6,3,9,1,1,0,0,15692,6.8,17598,217,32,189,-99,21.7,1569.2,16,3,1,3,6,2,0,0,0,0,15503,6.6,17697,244,48,-189,99,24.4,1550.3
4525762276,1,17,4,0,8,10,11,1,1,0,0,17541,7.0,18201,216,52,-862,931,21.6,1754.1,128,2,1,10,8,16,0,0,0,0,18403,7.0,17270,219,46,862,-931,21.9,1840.3
4521868981,1,17,2,1,8,3,7,0,0,0,0,17840,6.8,18356,233,40,3047,1616,23.3,1784.0,19,6,0,3,8,3,1,1,0,0,14793,6.6,16740,229,54,-3047,-1616,22.9,1479.3
4503591121,1,17,6,0,7,8,7,1,1,0,0,17459,6.8,17773,209,56,-1,-459,20.9,1745.9,42,5,1,8,7,6,0,0,0,0,17460,6.8,18232,231,52,1,459,23.1,1746.0
4459832099,1,18,1,1,9,3,6,2,1,1,0,19155,7.6,20750,251,88,4526,2759,25.1,1915.5,14,4,0,3,9,3,0,0,0,0,14629,7.0,17991,192,48,-4526,-2759,19.2,1462.9
4524232031,1,36,2,1,6,10,6,1,1,0,0,15385,6.6,16039,210,48,-3134,-2772,21.0,1538.5,17,2,0,10,6,8,0,0,0,0,18519,7.0,18811,232,47,3134,2772,23.2,1851.9
4521042540,1,14,2,1,8,7,7,1,1,0,0,18271,7.4,19689,223,55,938,181,22.3,1827.1,10,1,0,7,8,6,1,0,1,0,17333,7.2,19508,204,52,-938,-181,20.4,1733.3
4480445150,1,16,0,0,4,5,6,2,1,1,0,16127,6.8,17245,235,55,1210,1410,23.5,1612.7,19,4,1,5,4,3,0,0,0,0,14917,6.4,15835,191,40,-1210,-1410,19.1,1491.7
4450271730,1,14,2,0,5,8,3,1,1,0,0,15069,6.6,16824,198,46,-1974,-589,19.8,1506.9,25,1,1,8,5,12,0,0,0,0,17043,6.8,17413,216,40,1974,589,21.6,1704.3
4464439713,1,17,2,1,8,4,7,1,0,1,0,16784,6.6,17242,212,40,1424,1060,21.2,1678.4,13,4,0,4,8,5,0,0,0,0,15360,6.4,16182,180,61,-1424,-1060,18.0,1536.0
4445877402,1,16,2,1,10,4,9,1,0,1,0,17933,7.2,19728,217,52,2690,2444,21.7,1793.3,14,2,0,4,10,6,1,1,0,0,15243,6.8,17284,213,56,-2690,-2444,21.3,1524.3
4497697674,1,18,3,1,6,2,10,1,1,0,0,16623,7.2,18555,211,54,1792,-764,21.1,1662.3,13,3,0,2,6,2,1,0,1,0,14831,7.0,19319,223,72,-1792,764,22.3,1483.1
4523908586,1,14,0,0,11,5,9,1,1,0,0,18604,7.4,20075,214,53,2998,3108,21.4,1860.4,14,3,1,5,11,4,0,0,0,0,15606,7.0,16967,203,42,-2998,-3108,20.3,1560.6
4489475573,1,13,4,1,11,11,14,0,0,0,0,18795,7.4,19236,231,43,733,675,23.1,1879.5,127,3,0,11,11,11,1,1,0,0,18062,7.0,18561,213,32,-733,-675,21.3,1806.2
4520833786,1,17,1,1,10,6,10,0,0,0,0,18559,7.0,18239,223,61,2606,964,22.3,1855.9,16,0,0,6,10,6,1,1,0,0,15953,6.8,17275,203,60,-2606,-964,20.3,1595.3
4527589984,1,37,3,0,6,5,7,2,1,1,1,17486,7.2,17915,215,52,1389,490,21.5,1748.6,17,3,1,5,6,5,0,0,0,0,16097,6.8,17425,198,71,-1389,-490,19.8,1609.7
4523930264,1,17,6,0,11,4,14,0,0,0,1,19350,7.4,19830,234,39,4553,3000,23.4,1935.0,16,0,1,4,11,2,0,0,0,0,14797,6.4,16830,208,52,-4553,-3000,20.8,1479.7
4524327069,1,16,2,0,6,4,11,0,0,0,0,17438,7.2,18793,249,71,2152,1936,24.9,1743.8,18,3,1,4,6,7,2,1,1,0,15286,6.8,16857,227,41,-2152,-1936,22.7,1528.6
4501521847,1,90,3,1,13,5,17,1,1,0,0,18787,7.0,17878,193,40,3886,1777,19.3,1878.7,14,3,0,5,13,5,0,0,0,0,14901,6.6,16101,175,43,-3886,-1777,17.5,1490.1
4525047411,1,19,1,1,5,2,6,0,0,0,0,16622,7.2,19176,235,61,2061,1314,23.5,1662.2,20,2,0,2,5,0,0,0,0,0,14561,7.0,17862,219,67,-2061,-1314,21.9,1456.1
4518666221,1,16,4,1,2,3,3,0,0,0,0,15076,6.4,16299,196,51,-426,-2349,19.6,1507.6,14,2,0,3,2,3,1,0,1,0,15502,6.8,18648,218,64,426,2349,21.8,1550.2
4469192486,1,11,4,1,18,13,6,0,0,0,1,21132,7.2,19294,236,44,2658,2407,23.6,2113.2,166,0,0,13,18,16,0,0,0,0,18474,6.6,16887,154,31,-2658,-2407,15.4,1847.4
4522338858,1,52,3,0,4,7,5,1,1,0,0,15766,7.0,18750,232,60,-1035,582,23.2,1576.6,18,4,1,7,4,7,0,0,0,0,16801,7.0,18168,202,55,1035,-582,20.2,1680.1
4524698589,1,80,3,1,7,2,7,1,1,0,0,17324,7.2,19349,216,48,3129,2922,21.6,1732.4,18,0,0,2,7,3,0,0,0,0,14195,6.8,16427,208,47,-3129,-2922,20.8,1419.5
4509949605,1,17,3,0,7,7,9,0,0,0,0,16323,7.2,18362,213,44,-451,336,21.3,1632.3,63,5,1,7,7,10,1,1,0,0,16774,6.8,18026,219,44,451,-336,21.9,1677.4
4486171002,1,11,5,0,4,12,3,0,0,0,0,15639,6.4,17326,227,55,-2608,-1326,22.7,1563.9,19,2,1,12,4,13,0,0,0,0,18247,7.0,18652,198,52,2608,1326,19.8,1824.7
4525030965,1,36,1,1,11,6,10,1,0,1,0,18849,7.2,19086,220,65,3281,1747,22.0,1884.9,9,4,0,6,11,3,1,1,0,0,15568,6.8,17339,202,56,-3281,-1747,20.2,1556.8
4410127520,1,17,15,0,9,3,9,0,0,0,0,18125,7.8,21102,236,48,2828,2738,23.6,1812.5,63,5,1,3,9,2,1,1,0,0,15297,7.2,18364,227,71,-2828,-2738,22.7,1529.7
4495247088,1,13,3,0,5,5,6,1,0,1,0,16897,7.2,18457,218,68,942,952,21.8,1689.7,14,5,1,5,5,4,0,0,0,0,15955,6.8,17505,220,57,-942,-952,22.0,1595.5
4499396422,1,40,6,1,4,4,8,0,0,0,0,15947,6.8,17352,231,41,247,-1191,23.1,1594.7,17,2,0,4,4,5,1,1,0,0,15700,6.8,18543,219,75,-247,1191,21.9,1570.0
4511628511,1,15,1,1,7,5,9,1,1,0,0,17791,7.0,19243,244,71,2037,2483,24.4,1779.1,14,4,0,5,7,5,0,0,0,0,15754,6.6,16760,209,36,-2037,-2483,20.9,1575.4
4479804307,1,16,2,1,10,6,12,1,1,0,0,18439,7.2,18689,223,39,1894,99,22.3,1843.9,12,4,0,6,10,5,0,0,0,0,16545,7.0,18590,203,48,-1894,-99,20.3,1654.5
4515220685,1,19,1,0,6,6,3,0,0,0,0,16780,6.8,18032,244,54,253,-529,24.4,1678.0,19,4,1,6,6,6,2,1,1,0,16527,7.2,18561,222,58,-253,529,22.2,1652.7
4444970542,1,63,0,0,8,3,11,1,1,0,0,17701,7.2,19075,246,52,2252,1577,24.6,1770.1,14,2,1,3,8,3,0,0,0,0,15449,6.8,17498,228,46,-2252,-1577,22.8,1544.9
4450369263,1,18,2,1,2,4,2,1,1,0,0,14922,7.2,18119,227,65,-1316,-1111,22.7,1492.2,22,2,0,4,2,1,0,0,0,0,16238,6.8,19230,247,65,1316,1111,24.7,1623.8
4477398725,1,16,3,1,9,8,12,0,0,0,0,17121,6.6,16462,212,36,217,434,21.2,1712.1,16,1,0,8,9,9,1,0,1,0,16904,6.4,16028,173,35,-217,-434,17.3,1690.4
4498562536,1,17,4,1,7,9,3,0,0,0,0,15609,6.8,16832,182,38,-2569,-2934,18.2,1560.9,15,1,0,9,7,9,0,0,0,0,18178,7.6,19766,212,70,2569,2934,21.2,1817.8
4505820252,1,14,1,0,2,3,2,2,1,1,0,16394,7.4,20016,264,85,1447,1753,26.4,1639.4,13,3,1,3,2,1,0,0,0,0,14947,6.8,18263,227,54,-1447,-1753,22.7,1494.7
4485823957,1,24,2,0,7,4,11,0,0,0,0,18113,7.2,19187,231,49,1350,524,23.1,1811.3,16,5,1,4,7,6,0,0,0,0,16763,7.0,18663,262,65,-1350,-524,26.2,1676.3
4492994895,1,11,2,1,4,4,0,1,0,1,0,15620,7.2,18558,239,56,-1761,-385,23.9,1562.0,18,0,0,4,4,8,1,1,0,1,17381,7.4,18943,243,54,1761,385,24.3,1738.1
4523578015,1,14,1,0,7,3,6,0,0,0,0,16060,7.0,18431,228,44,794,577,22.8,1606.0,16,1,1,3,7,4,0,0,0,0,15266,7.0,17854,213,44,-794,-577,21.3,1526.6
4498404672,1,8,1,1,7,3,6,0,0,0,0,17204,7.4,19558,255,48,2385,966,25.5,1720.4,37,0,0,3,7,4,1,1,0,0,14819,7.0,18592,215,52,-2385,-966,21.5,1481.9
4487686105,1,12,4,1,8,4,11,0,0,0,0,16763,7.0,17757,216,34,147,-712,21.6,1676.3,14,2,0,4,8,8,0,0,0,0,16616,7.0,18469,240,64,-147,712,24.0,1661.6
4519280079,1,24,5,0,3,5,2,1,1,0,0,14247,6.6,16806,226,41,-1597,-715,22.6,1424.7,38,5,1,5,3,8,1,0,1,0,15844,6.8,17521,218,47,1597,715,21.8,1584.4
4478456612,1,40,6,0,4,4,5,0,0,0,0,15894,7.0,18853,223,60,310,536,22.3,1589.4,19,5,1,4,4,4,1,1,0,0,15584,7.0,18317,223,54,-310,-536,22.3,1558.4
4511778720,1,16,1,1,8,2,10,1,0,1,0,17300,7.0,19249,223,44,2298,1572,22.3,1730.0,13,1,0,2,8,0,1,1,0,0,15002,7.0,17677,248,64,-2298,-1572,24.8,1500.2
4477340237,1,19,4,1,8,6,8,1,1,0,0,16984,6.8,17114,205,48,469,-755,20.5,1698.4,41,4,0,6,8,5,1,0,1,0,16515,7.0,17869,233,47,-469,755,23.3,1651.5
4417621987,1,17,6,1,8,8,12,0,0,0,0,17856,6.8,18232,221,50,226,-955,22.1,1785.6,11,2,0,8,8,8,1,1,0,0,17630,7.2,19187,221,50,-226,955,22.1,1763.0
4492581093,1,14,0,1,4,4,6,0,0,0,0,15866,7.0,18127,221,53,218,-598,22.1,1586.6,40,3,0,4,4,4,1,1,0,0,15648,7.2,18725,219,60,-218,598,21.9,1564.8
4509107682,1,17,2,0,6,7,8,0,0,0,0,16107,7.2,17763,231,39,-621,-23,23.1,1610.7,16,5,1,7,6,9,1,1,0,0,16728,6.8,17786,216,43,621,23,21.6,1672.8
4522859365,1,16,5,0,9,2,16,1,1,0,0,18984,7.4,20083,254,54,4620,2871,25.4,1898.4,16,2,1,2,9,3,0,0,0,0,14364,6.6,17212,171,59,-4620,-2871,17.1,1436.4
4517744758,1,15,2,1,8,3,7,1,0,1,0,17194,7.2,18529,197,48,2772,2140,19.7,1719.4,56,3,0,3,8,3,0,0,0,0,14422,6.6,16389,188,44,-2772,-2140,18.8,1442.2
4497569753,1,16,4,0,7,9,7,0,0,0,0,17569,7.2,18822,239,42,-72,529,23.9,1756.9,40,1,1,9,7,11,2,1,1,0,17641,7.0,18293,209,56,72,-529,20.9,1764.1
4467262571,1,12,0,0,7,9,4,1,0,1,0,17075,6.8,17991,218,54,-372,177,21.8,1707.5,45,2,1,9,7,11,0,0,0,0,17447,7.0,17814,217,36,372,-177,21.7,1744.7
4494451002,1,16,4,1,8,3,7,1,1,0,0,16225,6.8,17748,179,44,195,428,17.9,1622.5,17,0,0,3,8,4,0,0,0,0,16030,6.6,17320,239,39,-195,-428,23.9,1603.0
4518542421,1,16,4,0,11,11,9,1,1,0,0,19116,7.0,19104,220,56,1159,3144,22.0,1911.6,20,0,1,11,11,14,0,0,0,0,17957,6.4,15960,169,31,-1159,-3144,16.9,1795.7
4484045621,1,40,1,1,10,7,16,2,1,1,0,18989,7.2,19584,201,67,2545,1695,20.1,1898.9,40,3,0,7,10,11,0,0,0,0,16444,7.0,17889,212,38,-2545,-1695,21.2,1644.4
4506933329,1,15,1,0,4,6,2,1,1,0,0,15340,7.2,18245,228,44,-1031,122,22.8,1534.0,13,4,1,6,4,7,0,0,0,0,16371,7.0,18123,228,51,1031,-122,22.8,1637.1
4527087399,1,13,1,0,6,7,6,0,0,0,0,16070,6.6,17613,194,48,-1245,-971,19.4,1607.0,13,2,1,7,6,10,1,1,0,0,17315,7.0,18584,237,60,1245,971,23.7,1731.5
4525312935,1,22,1,0,6,4,4,1,0,1,0,16926,7.2,19020,229,52,1947,1677,22.9,1692.6,17,3,1,4,6,1,1,1,0,0,14979,6.8,17343,230,44,-1947,-1677,23.0,1497.9
4522081916,1,19,4,0,9,9,11,1,1,0,0,18376,7.2,18388,238,46,653,462,23.8,1837.6,14,6,1,9,9,18,0,0,0,0,17723,7.0,17926,204,44,-653,-462,20.4,1772.3
4515418591,1,15,4,1,7,2,6,1,0,1,1,17819,7.2,19319,236,44,2979,1183,23.6,1781.9,18,1,0,2,7,1,1,1,0,0,14840,7.0,18136,223,72,-2979,-1183,22.3,1484.0
4515867016,1,13,2,0,4,3,6,1,1,0,0,14972,6.8,17357,201,49,-266,-613,20.1,1497.2,37,1,1,3,4,4,1,0,1,0,15238,7.0,17970,233,46,266,613,23.3,1523.8
4510120989,1,18,5,1,8,6,11,1,1,0,0,17287,7.0,18312,224,45,886,684,22.4,1728.7,45,3,0,6,8,8,0,0,0,0,16401,6.8,17628,228,32,-886,-684,22.8,1640.1
4517741452,1,38,0,1,6,4,7,2,1,1,0,16886,6.8,18261,221,56,184,-131,22.1,1688.6,16,4,0,4,6,5,0,0,0,0,16702,7.0,18392,237,64,-184,131,23.7,1670.2
4495300852,1,15,5,1,13,3,13,0,0,0,0,20183,7.6,20925,239,48,5712,4581,23.9,2018.3,14,3,0,3,13,3,0,0,0,0,14471,6.6,16344,208,36,-5712,-4581,20.8,1447.1
4464257134,1,15,2,1,6,6,6,1,0,1,0,16866,6.8,17542,218,47,69,-552,21.8,1686.6,18,1,0,6,6,9,1,1,0,0,16797,6.8,18094,247,40,-69,552,24.7,1679.7
4497853195,1,17,5,1,9,3,11,0,0,0,0,19153,7.4,20631,262,51,4003,2755,26.2,1915.3,18,2,0,3,9,3,1,1,0,0,15150,7.2,17876,225,55,-4003,-2755,22.5,1515.0
4478159300,1,16,5,0,5,1,5,1,1,0,0,16352,7.2,19028,250,52,1824,1204,25.0,1635.2,20,4,1,1,5,2,0,0,0,0,14528,7.0,17824,239,52,-1824,-1204,23.9,1452.8
4517486439,1,19,3,1,8,2,12,0,0,0,0,17432,7.2,18495,209,44,2673,1388,20.9,1743.2,11,2,0,2,8,4,1,1,0,0,14759,6.6,17107,216,64,-2673,-1388,21.6,1475.9
4524701312,1,16,2,1,6,5,5,2,1,1,0,16555,6.8,18782,224,57,-11,-176,22.4,1655.5,18,1,0,5,6,5,0,0,0,0,16566,7.4,18958,227,56,11,176,22.7,1656.6
4513797565,1,16,1,1,11,5,10,1,1,0,0,19245,7.6,20286,245,60,3108,2974,24.5,1924.5,58,2,0,5,11,6,0,0,0,0,16137,6.8,17312,194,64,-3108,-2974,19.4,1613.7
4475994865,1,20,5,1,11,3,12,1,1,0,0,18802,7.0,18095,224,51,3781,1725,22.4,1880.2,17,3,0,3,11,2,0,0,0,0,15021,6.6,16370,222,44,-3781,-1725,22.2,1502.1
4427804202,1,13,4,0,7,6,14,1,1,0,0,16304,6.2,15338,182,45,-61,-1738,18.2,1630.4,18,1,1,6,7,8,0,0,0,0,16365,6.4,17076,219,44,61,1738,21.9,1636.5
4477518558,1,19,1,0,9,8,13,1,1,0,0,17813,6.8,17461,202,66,986,549,20.2,1781.3,15,2,1,8,9,13,0,0,0,0,16827,6.6,16912,216,39,-986,-549,21.6,1682.7
4521916214,1,16,8,0,6,11,7,1,1,0,0,15246,6.6,16135,174,43,-2974,-2746,17.4,1524.6,26,3,1,11,6,9,1,0,1,0,18220,7.2,18881,198,59,2974,2746,19.8,1822.0
4450237694,1,19,5,1,8,9,9,0,0,0,0,18529,7.2,19610,251,63,1334,656,25.1,1852.9,38,4,0,9,8,11,1,1,0,0,17195,7.0,18954,202,60,-1334,-656,20.2,1719.5
4523068709,1,36,3,1,5,4,6,0,0,0,1,17519,6.8,17307,215,46,1953,135,21.5,1751.9,15,2,0,4,5,6,0,0,0,0,15566,6.6,17172,215,48,-1953,-135,21.5,1556.6
4507103661,1,13,1,1,8,7,6,1,0,1,1,18271,6.8,18004,223,46,1656,95,22.3,1827.1,13,0,0,7,8,6,1,1,0,0,16615,7.0,17909,226,54,-1656,-95,22.6,1661.5
4516724149,1,17,6,0,6,9,3,1,1,0,0,16301,7.2,18968,235,60,-1207,606,23.5,1630.1,25,6,1,9,6,10,0,0,0,0,17508,7.0,18362,230,45,1207,-606,23.0,1750.8
4521318452,1,17,0,0,9,8,8,1,0,1,0,17657,7.2,19166,227,56,545,1033,22.7,1765.7,14,2,1,8,9,9,1,1,0,0,17112,7.0,18133,198,40,-545,-1033,19.8,1711.2
4447488924,1,16,3,1,12,6,17,1,1,0,0,20010,7.2,20053,208,56,4311,2572,20.8,2001.0,17,4,0,6,12,5,0,0,0,0,15699,6.8,17481,214,33,-4311,-2572,21.4,1569.9
4447660498,1,14,0,0,4,4,3,0,0,0,0,15548,6.8,17592,221,54,-112,398,22.1,1554.8,14,1,1,4,4,3,2,1,1,0,15660,6.8,17194,232,63,112,-398,23.2,1566.0
4515642835,1,13,2,1,16,5,17,1,1,0,0,21297,7.2,19371,221,42,6439,4362,22.1,2129.7,14,0,0,5,16,7,1,0,1,0,14858,6.2,15009,165,43,-6439,-4362,16.5,1485.8
4522319938,1,44,3,0,13,12,17,1,1,0,0,20175,7.4,20673,215,72,1610,2488,21.5,2017.5,14,14,1,12,13,13,0,0,0,0,18565,6.8,18185,212,36,-1610,-2488,21.2,1856.5
4519198030,1,17,8,0,8,8,11,0,0,0,0,17178,7.0,18476,216,44,-597,-1198,21.6,1717.8,21,3,1,8,8,6,0,0,0,0,17775,7.4,19674,253,52,597,1198,25.3,1777.5
4519784011,1,33,2,0,11,7,12,1,1,0,1,19241,7.0,18942,198,50,1350,577,19.8,1924.1,12,1,1,7,11,11,0,0,0,0,17891,7.0,18365,247,44,-1350,-577,24.7,1789.1
4471258643,1,15,2,0,9,6,9,0,0,0,0,17174,6.8,18060,212,32,1514,1421,21.2,1717.4,37,1,1,6,9,6,1,0,1,0,15660,6.8,16639,187,44,-1514,-1421,18.7,1566.0
4494473176,1,19,4,1,8,9,12,1,1,0,0,16096,6.4,15907,197,48,-447,-2127,19.7,1609.6,40,5,0,9,8,7,0,0,0,0,16543,7.0,18034,193,36,447,2127,19.3,1654.3
4513621339,1,41,1,1,4,9,5,1,1,0,0,15316,6.6,17118,198,52,-2986,-3369,19.8,1531.6,13,9,0,9,4,3,0,0,0,0,18302,7.4,20487,247,64,2986,3369,24.7,1830.2
4494350446,1,16,1,1,8,4,7,2,1,1,0,17634,7.0,19000,242,46,2018,2261,24.2,1763.4,31,1,0,4,8,2,0,0,0,0,15616,6.6,16739,233,50,-2018,-2261,23.3,1561.6
4522499744,1,15,1,1,5,7,6,1,1,0,0,16328,6.8,17945,241,50,-972,-1814,24.1,1632.8,15,0,0,7,5,8,0,0,0,0,17300,7.2,19759,233,53,972,1814,23.3,1730.0
4517920600,1,16,4,0,6,7,5,1,1,0,0,15882,7.2,18675,198,68,-1019,-361,19.8,1588.2,15,3,1,7,6,5,0,0,0,0,16901,7.0,19036,240,56,1019,361,24.0,1690.1
4523300561,1,12,1,1,11,2,9,1,1,0,0,19280,7.6,20813,252,51,5041,3996,25.2,1928.0,19,4,0,2,11,3,0,0,0,0,14239,6.8,16817,215,59,-5041,-3996,21.5,1423.9
4482138912,1,19,2,1,9,7,19,0,0,0,0,19092,7.2,19183,226,44,2035,1188,22.6,1909.2,18,2,0,7,9,8,1,1,0,0,17057,7.0,17995,214,56,-2035,-1188,21.4,1705.7
4496746747,1,55,3,1,7,5,5,0,0,0,0,16812,7.0,19678,228,56,1322,2276,22.8,1681.2,17,4,0,5,7,5,1,1,0,0,15490,6.6,17402,215,64,-1322,-2276,21.5,1549.0
4515483154,1,34,1,0,8,5,8,1,1,0,0,17204,7.2,19878,215,66,803,2597,21.5,1720.4,16,2,1,5,8,7,0,0,0,0,16401,6.8,17281,216,53,-803,-2597,21.6,1640.1
4445812835,1,15,0,0,8,10,8,0,0,0,0,16622,6.6,16799,170,32,-1129,-1742,17.0,1662.2,36,5,1,10,8,10,1,1,0,0,17751,7.2,18541,211,45,1129,1742,21.1,1775.1
4495413330,1,43,4,0,5,8,4,0,0,0,0,16616,7.4,19302,240,64,-616,728,24.0,1661.6,16,5,1,8,5,9,1,1,0,0,17232,7.2,18574,234,48,616,-728,23.4,1723.2
4504857073,1,14,3,0,9,10,5,1,1,0,0,17302,6.8,17065,197,39,-1085,-1716,19.7,1730.2,17,0,1,10,9,9,0,0,0,0,18387,7.2,18781,208,67,1085,1716,20.8,1838.7
4519376202,1,14,2,1,5,3,4,1,1,0,0,15836,7.0,18174,223,44,813,487,22.3,1583.6,14,1,0,3,5,3,0,0,0,0,15023,6.8,17687,219,64,-813,-487,21.9,1502.3
4413141960,1,17,2,1,2,2,3,0,0,0,0,14619,6.6,16874,244,40,622,-1048,24.4,1461.9,41,3,0,2,2,1,1,1,0,0,13997,6.8,17922,198,51,-622,1048,19.8,1399.7
4522076814,1,16,5,1,8,6,7,1,1,0,0,17751,7.2,19165,238,60,1570,643,23.8,1775.1,38,3,0,6,8,1,0,0,0,0,16181,7.0,18522,226,52,-1570,-643,22.6,1618.1
4440050075,1,17,1,1,7,1,5,1,1,0,1,18772,7.2,18771,255,55,5169,2153,25.5,1877.2,10,3,0,1,7,1,0,0,0,0,13603,6.6,16618,200,48,-5169,-2153,20.0,1360.3
4526361954,1,24,0,1,8,2,9,1,1,0,1,17422,6.8,17192,211,24,2394,-1292,21.1,1742.2,36,5,0,2,8,3,0,0,0,0,15028,7.0,18484,210,76,-2394,1292,21.0,1502.8
4515916030,1,87,3,0,12,4,15,0,0,0,0,18596,7.2,18850,188,55,3378,3168,18.8,1859.6,15,3,1,4,12,6,1,1,0,0,15218,6.4,15682,207,43,-3378,-3168,20.7,1521.8
4522317510,1,19,4,0,6,4,9,0,0,0,0,16317,6.8,16936,210,39,1163,-539,21.0,1631.7,19,4,1,4,6,1,1,1,0,0,15154,6.8,17475,241,32,-1163,539,24.1,1515.4
4522036239,1,17,3,1,11,3,11,1,0,1,0,18479,7.4,19708,232,48,3187,1811,23.2,1847.9,16,5,0,3,11,2,1,1,0,0,15292,6.8,17897,258,50,-3187,-1811,25.8,1529.2
4474770389,1,19,2,1,5,4,7,1,1,0,0,16359,7.0,18199,210,64,917,-90,21.0,1635.9,15,1,0,4,5,4,0,0,0,0,15442,7.0,18289,218,55,-917,90,21.8,1544.2
4526872283,1,39,2,1,4,0,6,1,1,0,0,15388,6.8,17788,220,52,365,-719,22.0,1538.8,18,1,0,0,4,0,0,0,0,0,15023,6.8,18507,252,76,-365,719,25.2,1502.3
4505728122,1,18,0,0,6,9,7,1,1,0,0,15596,6.2,15360,197,26,-2600,-2112,19.7,1559.6,18,1,1,9,6,7,1,0,1,1,18196,6.6,17472,185,52,2600,2112,18.5,1819.6
4469852956,1,17,3,0,5,5,4,0,0,0,0,16545,7.2,19148,235,67,-207,-251,23.5,1654.5,15,4,1,5,5,6,1,1,0,0,16752,7.2,19399,235,72,207,251,23.5,1675.2
4512161240,1,17,5,1,8,7,4,1,0,1,0,17505,7.2,19027,236,48,1014,850,23.6,1750.5,18,2,0,7,8,5,1,1,0,0,16491,7.0,18177,201,60,-1014,-850,20.1,1649.1
4495631767,1,17,9,1,9,2,9,2,1,1,1,20464,7.4,19989,251,65,6597,4613,25.1,2046.4,15,2,0,2,9,2,0,0,0,0,13867,6.2,15376,215,40,-6597,-4613,21.5,1386.7
4463289443,1,17,5,1,8,4,10,0,0,0,0,18326,7.2,19015,239,51,3517,2356,23.9,1832.6,19,6,0,4,8,4,1,0,1,0,14809,6.6,16659,203,24,-3517,-2356,20.3,1480.9
4519515708,1,19,1,1,11,1,18,1,1,0,0,18190,7.6,20017,225,65,4069,3954,22.5,1819.0,16,5,0,1,11,1,0,0,0,0,14121,6.6,16063,224,51,-4069,-3954,22.4,1412.1
4492081907,1,21,2,1,7,2,10,1,1,0,0,16867,7.2,18156,232,36,2474,1015,23.2,1686.7,149,2,0,2,7,2,0,0,0,0,14393,6.6,17141,230,52,-2474,-1015,23.0,1439.3
4490468164,1,15,5,0,4,7,4,0,0,0,0,15777,6.8,17261,229,48,-621,-784,22.9,1577.7,57,1,1,7,4,14,1,1,0,0,16398,7.0,18045,204,56,621,784,20.4,1639.8
4523130201,1,41,6,0,7,5,10,1,1,0,0,16583,7.2,17389,222,44,840,385,22.2,1658.3,17,5,1,5,7,4,0,0,0,0,15743,6.8,17004,213,48,-840,-385,21.3,1574.3
4497712537,1,17,4,1,6,6,11,1,1,0,0,17731,7.2,18498,257,59,1870,1167,25.7,1773.1,20,1,0,6,6,6,1,0,1,0,15861,6.8,17331,216,42,-1870,-1167,21.6,1586.1
4520037654,1,18,3,1,5,2,4,2,1,1,0,15925,6.8,17913,228,56,1946,1292,22.8,1592.5,20,0,0,2,5,2,0,0,0,0,13979,6.8,16621,213,46,-1946,-1292,21.3,1397.9
4492333957,1,14,1,1,9,5,7,1,0,1,0,18348,7.2,19545,216,62,3111,2739,21.6,1834.8,13,0,0,5,9,4,1,1,0,0,15237,6.8,16806,202,51,-3111,-2739,20.2,1523.7
4520513993,1,13,5,1,10,3,9,1,1,0,0,19013,7.4,20151,225,60,4817,3220,22.5,1901.3,14,4,0,3,10,3,1,0,1,0,14196,6.8,16931,184,48,-4817,-3220,18.4,1419.6
4476043495,1,14,2,0,8,6,9,0,0,0,0,16694,6.8,17192,227,32,370,92,22.7,1669.4,32,4,1,6,8,6,1,1,0,0,16324,6.8,17100,213,48,-370,-92,21.3,1632.4
4419611773,1,18,2,1,10,11,13,0,0,0,0,17447,6.4,16191,173,38,-384,-1658,17.3,1744.7,12,1,0,11,10,9,0,0,0,0,17831,7.0,17849,208,40,384,1658,20.8,1783.1
4518569254,1,38,4,1,5,7,6,1,1,0,0,15671,6.8,17411,205,44,-981,-994,20.5,1567.1,15,4,0,7,5,8,0,0,0,0,16652,6.8,18405,219,53,981,994,21.9,1665.2
4520326314,1,16,1,1,6,3,5,0,0,0,0,16298,7.0,19052,229,56,823,1225,22.9,1629.8,13,4,0,3,6,3,1,1,0,0,15475,6.8,17827,235,52,-823,-1225,23.5,1547.5
4526061513,1,14,2,0,9,10,9,1,0,1,0,17840,7.2,19273,226,45,-359,784,22.6,1784.0,16,3,1,10,9,9,1,1,0,0,18199,7.0,18489,207,50,359,-784,20.7,1819.9
4424234082,1,14,6,1,8,3,8,0,0,0,0,17608,7.2,18800,210,43,2185,955,21.0,1760.8,20,0,0,3,8,4,0,0,0,0,15423,6.8,17845,231,53,-2185,-955,23.1,1542.3
4483768812,1,42,4,0,4,8,7,1,1,0,0,16220,6.8,17447,227,60,-444,-184,22.7,1622.0,58,8,1,8,4,12,0,0,0,0,16664,7.0,17631,212,46,444,184,21.2,1666.4
4516284402,1,35,2,0,10,6,8,0,0,0,0,18165,7.0,18510,219,57,2746,999,21.9,1816.5,23,10,1,6,10,3,0,0,0,0,15419,6.8,17511,206,49,-2746,-999,20.6,1541.9
4520943763,1,13,16,1,9,8,13,1,1,0,0,17060,6.8,17673,207,64,143,845,20.7,1706.0,39,3,0,8,9,7,0,0,0,0,16917,6.6,16828,212,48,-143,-845,21.2,1691.7
4426767631,1,18,1,1,7,1,8,0,0,0,0,17177,7.0,19119,223,40,3368,2352,22.3,1717.7,16,3,0,1,7,1,1,1,0,0,13809,6.6,16767,205,48,-3368,-2352,20.5,1380.9
4509730924,1,16,1,0,7,5,8,0,0,0,0,16294,6.8,18342,214,50,-18,252,21.4,1629.4,17,1,1,5,7,4,0,0,0,0,16312,7.0,18090,229,45,18,-252,22.9,1631.2
4480259472,1,34,18,1,9,4,9,1,1,0,0,19462,7.6,19955,239,68,4444,2813,23.9,1946.2,39,1,0,4,9,3,0,0,0,0,15018,6.6,17142,209,48,-4444,-2813,20.9,1501.8
4508272671,1,14,4,1,9,5,11,1,1,0,0,17120,7.0,17636,163,56,1426,128,16.3,1712.0,18,3,0,5,9,2,0,0,0,0,15694,6.8,17508,207,52,-1426,-128,20.7,1569.4
4500614731,1,39,3,0,3,5,3,0,0,0,0,15610,7.2,19049,246,57,-99,727,24.6,1561.0,16,1,1,5,3,7,0,0,0,0,15709,6.8,18322,234,48,99,-727,23.4,1570.9
4522201700,1,17,1,0,4,4,3,0,0,0,0,15688,6.8,18341,237,51,91,591,23.7,1568.8,21,5,1,4,4,6,0,0,0,0,15597,6.8,17750,239,54,-91,-591,23.9,1559.7
4484950651,1,18,3,1,10,0,8,0,0,0,0,18408,7.4,19945,243,52,5041,3633,24.3,1840.8,15,3,0,0,10,0,0,0,0,0,13367,6.6,16312,202,57,-5041,-3633,20.2,1336.7
4472130589,1,15,5,0,4,7,2,1,1,0,0,15682,6.8,17438,234,60,-1075,73,23.4,1568.2,19,2,1,7,4,6,0,0,0,0,16757,6.8,17365,213,51,1075,-73,21.3,1675.7
4523546666,1,16,1,0,5,3,6,0,0,0,0,16169,7.2,18880,235,60,561,740,23.5,1616.9,14,0,1,3,5,3,0,0,0,0,15608,7.0,18140,235,59,-561,-740,23.5,1560.8
4515471946,1,16,7,1,7,4,9,0,0,0,0,16535,7.0,17582,230,33,443,-1176,23.0,1653.5,21,2,0,4,7,3,0,0,0,0,16092,7.0,18758,216,64,-443,1176,21.6,1609.2
4432011419,1,15,3,0,6,8,10,0,0,0,0,15579,6.8,16747,204,46,-1815,-1309,20.4,1557.9,15,3,1,8,6,8,2,1,1,0,17394,7.0,18056,205,59,1815,1309,20.5,1739.4
4520004131,1,14,4,1,5,5,4,1,1,0,0,15885,6.6,16411,213,54,-508,-1263,21.3,1588.5,35,1,0,5,5,5,0,0,0,0,16393,7.0,17674,235,46,508,1263,23.5,1639.3
4521651698,1,21,1,0,5,2,2,1,1,0,0,16344,7.4,19730,234,59,2032,2833,23.4,1634.4,14,2,1,2,5,2,0,0,0,0,14312,6.8,16897,212,48,-2032,-2833,21.2,1431.2
4453255599,1,17,3,0,10,13,8,1,0,1,0,18255,6.8,17685,206,29,-1237,-874,20.6,1825.5,14,1,1,13,10,22,0,0,0,0,19492,7.0,18559,203,50,1237,874,20.3,1949.2
4496739291,1,16,3,1,10,5,7,1,1,0,0,18240,7.0,19116,259,31,2953,1980,25.9,1824.0,17,2,0,5,10,4,0,0,0,0,15287,6.8,17136,197,64,-2953,-1980,19.7,1528.7
4521490447,1,84,1,1,8,5,8,1,0,1,0,17473,7.0,18577,228,48,1179,-736,22.8,1747.3,38,1,0,5,8,5,0,0,0,0,16294,7.4,19313,225,52,-1179,736,22.5,1629.4
4521756971,1,55,5,1,17,6,26,0,0,0,0,20604,6.8,18469,194,51,4565,2632,19.4,2060.4,23,5,0,6,17,6,1,1,0,0,16039,6.4,15837,202,32,-4565,-2632,20.2,1603.9
4517672775,1,15,1,1,7,3,11,1,1,0,0,17072,7.0,19087,227,52,1782,1234,22.7,1707.2,11,3,0,3,7,1,0,0,0,0,15290,7.0,17853,212,61,-1782,-1234,21.2,1529.0
4499523222,1,18,3,0,9,6,14,1,1,0,0,16945,6.8,17806,204,36,1574,761,20.4,1694.5,17,2,1,6,9,6,0,0,0,0,15371,6.8,17045,194,54,-1574,-761,19.4,1537.1
4507096347,1,20,3,1,6,7,4,1,1,0,0,17261,7.0,18583,206,56,1579,1615,20.6,1726.1,19,3,0,7,6,9,0,0,0,0,15682,6.6,16968,184,36,-1579,-1615,18.4,1568.2
4517700680,1,55,2,1,7,2,12,1,1,0,0,17340,7.2,19234,229,52,3125,1784,22.9,1734.0,16,1,0,2,7,2,0,0,0,0,14215,6.8,17450,219,50,-3125,-1784,21.9,1421.5
4468739944,1,17,2,0,8,5,16,1,1,0,0,16291,6.8,16847,179,42,478,1166,17.9,1629.1,20,4,1,5,8,8,0,0,0,0,15813,6.4,15681,205,40,-478,-1166,20.5,1581.3
4520629363,1,16,2,0,4,4,3,2,1,1,0,15875,6.8,18309,234,65,455,1305,23.4,1587.5,15,4,1,4,4,6,0,0,0,0,15420,6.4,17004,233,42,-455,-1305,23.3,1542.0
4515261143,1,8,0,1,4,3,2,1,1,0,0,15278,7.0,18693,227,49,734,355,22.7,1527.8,13,1,0,3,4,3,0,0,0,0,14544,7.2,18338,203,50,-734,-355,20.3,1454.4
4521004120,1,17,2,1,5,7,1,0,0,0,0,15446,6.6,16681,183,62,-1257,-1406,18.3,1544.6,86,1,0,7,5,5,1,1,0,0,16703,6.8,18087,186,56,1257,1406,18.6,1670.3
4512312350,1,16,2,1,7,4,4,1,1,0,0,17107,7.2,19237,218,68,2169,2453,21.8,1710.7,30,1,0,4,7,4,0,0,0,0,14938,6.6,16784,212,40,-2169,-2453,21.2,1493.8
4523048704,1,19,4,1,10,6,10,1,1,0,0,18013,7.2,18223,228,51,1446,-143,22.8,1801.3,18,5,0,6,10,5,0,0,0,0,16567,7.0,18366,216,63,-1446,143,21.6,1656.7
4439408623,1,19,0,0,1,2,1,1,1,0,0,14862,7.0,18359,237,56,9,-172,23.7,1486.2,13,2,1,2,1,2,1,0,1,0,14853,7.2,18531,199,80,-9,172,19.9,1485.3
4496572597,1,16,3,1,9,4,11,0,0,0,0,17326,7.2,19014,226,44,1132,269,22.6,1732.6,38,3,0,4,9,5,1,1,0,0,16194,7.2,18745,203,59,-1132,-269,20.3,1619.4
4514548275,1,20,4,1,7,3,8,2,1,1,0,17507,7.2,19641,250,64,2790,3073,25.0,1750.7,169,2,0,3,7,3,0,0,0,0,14717,6.6,16568,209,47,-2790,-3073,20.9,1471.7
4519646184,1,13,2,0,4,4,6,0,0,0,0,15800,7.4,19395,231,72,-302,764,23.1,1580.0,10,5,1,4,4,4,0,0,0,0,16102,7.2,18631,236,49,302,-764,23.6,1610.2
4512089912,1,22,2,1,5,6,4,0,0,0,0,15218,6.4,16539,211,48,-828,421,21.1,1521.8,14,4,0,6,5,10,0,0,0,0,16046,6.6,16118,206,34,828,-421,20.6,1604.6
4522671632,1,19,6,0,7,5,5,1,1,0,0,17381,7.2,19539,234,59,1300,1783,23.4,1738.1,14,10,1,5,7,6,0,0,0,0,16081,6.8,17756,227,52,-1300,-1783,22.7,1608.1
4499786529,1,86,3,1,6,10,5,0,0,0,0,17040,7.0,17805,215,50,-545,-1102,21.5,1704.0,17,6,0,10,6,9,1,1,0,0,17585,7.0,18907,214,40,545,1102,21.4,1758.5
4524341789,1,15,7,1,11,3,12,1,1,0,1,20206,7.4,19702,221,52,6275,4789,22.1,2020.6,15,0,0,3,11,2,0,0,0,0,13931,6.2,14913,187,40,-6275,-4789,18.7,1393.1
4510541398,1,16,1,1,8,2,5,1,1,0,0,17030,6.8,18285,212,47,1866,80,21.2,1703.0,17,3,0,2,8,2,0,0,0,0,15164,7.2,18205,246,57,-1866,-80,24.6,1516.4
4470122147,1,16,6,0,10,6,17,1,0,1,0,17859,7.0,17682,221,32,1711,264,22.1,1785.9,32,1,1,6,10,6,0,0,0,0,16148,6.8,17418,209,44,-1711,-264,20.9,1614.8
4524307745,1,12,8,0,3,4,2,1,0,1,0,15156,7.0,18116,217,51,-324,1651,21.7,1515.6,21,5,1,4,3,5,1,1,0,0,15480,6.6,16465,220,44,324,-1651,22.0,1548.0
4519414547,1,19,0,0,13,4,11,1,1,0,0,20127,7.0,19575,234,48,6202,5368,23.4,2012.7,16,1,1,4,13,5,0,0,0,0,13925,6.0,14207,175,28,-6202,-5368,17.5,1392.5
4487468549,1,15,3,0,12,7,16,0,0,0,0,19246,7.2,19668,231,40,2861,1432,23.1,1924.6,15,2,1,7,12,5,0,0,0,0,16385,6.8,18236,213,55,-2861,-1432,21.3,1638.5
4485497527,1,17,6,0,4,5,4,1,0,1,0,16178,7.6,19249,223,80,297,1259,22.3,1617.8,19,4,1,5,4,5,0,0,0,0,15881,7.0,17990,225,48,-297,-1259,22.5,1588.1
4493317372,1,12,1,1,5,4,5,1,1,0,0,15807,7.0,18131,219,59,70,409,21.9,1580.7,14,1,0,4,5,8,0,0,0,0,15737,7.0,17722,221,60,-70,-409,22.1,1573.7
4525999978,1,15,15,0,12,5,11,1,0,1,0,19659,7.2,19474,241,48,3745,1627,24.1,1965.9,27,3,1,5,12,6,0,0,0,0,15914,7.0,17847,230,53,-3745,-1627,23.0,1591.4
4515215762,1,17,3,0,8,3,8,2,1,1,0,17500,6.8,18340,229,55,3308,2114,22.9,1750.0,9,0,1,3,8,3,0,0,0,0,14192,6.6,16226,215,28,-3308,-2114,21.5,1419.2
4513473008,1,44,5,0,5,2,7,1,1,0,0,17126,6.8,17880,248,53,1936,448,24.8,1712.6,16,4,1,2,5,2,0,0,0,0,15190,6.8,17432,230,71,-1936,-448,23.0,1519.0
4481252753,1,38,3,1,10,4,10,1,1,0,0,17870,7.2,18803,177,59,1872,1869,17.7,1787.0,62,2,0,4,10,4,0,0,0,0,15998,6.8,16934,225,52,-1872,-1869,22.5,1599.8
4512263036,1,21,17,1,11,6,14,2,1,1,0,18894,6.8,17315,201,51,3536,1244,20.1,1889.4,46,5,0,6,11,5,0,0,0,0,15358,6.6,16071,187,36,-3536,-1244,18.7,1535.8
4517750009,1,12,2,1,6,7,9,1,1,0,0,16815,7.2,17824,235,48,683,-208,23.5,1681.5,15,0,0,7,6,12,1,0,1,0,16132,6.8,18032,179,48,-683,208,17.9,1613.2
4511197912,1,43,2,1,12,7,13,0,0,0,0,18278,6.8,17024,191,24,2352,707,19.1,1827.8,17,5,0,7,12,9,0,0,0,0,15926,6.6,16317,189,45,-2352,-707,18.9,1592.6
4527873286,1,17,2,1,7,4,5,1,1,0,0,17765,7.2,18967,211,69,2519,2469,21.1,1776.5,46,3,0,4,7,7,0,0,0,0,15246,6.8,16498,229,34,-2519,-2469,22.9,1524.6
4503181649,1,18,4,1,5,2,8,0,0,0,0,16684,7.4,19585,240,59,2672,1784,24.0,1668.4,15,2,0,2,5,2,0,0,0,0,14012,7.0,17801,220,47,-2672,-1784,22.0,1401.2
4475660855,1,32,4,1,10,9,7,0,0,0,0,17584,6.4,16118,159,47,316,-1561,15.9,1758.4,39,2,0,9,10,8,0,0,0,0,17268,6.6,17679,202,47,-316,1561,20.2,1726.8
4514389880,1,15,7,1,7,3,5,2,1,1,0,16742,7.4,19145,215,67,1468,932,21.5,1674.2,85,1,0,3,7,2,0,0,0,0,15274,7.2,18213,247,60,-1468,-932,24.7,1527.4
4516335736,1,20,3,1,12,8,11,0,0,0,0,18713,7.2,19848,226,48,1355,1403,22.6,1871.3,16,2,0,8,12,7,1,1,0,0,17358,7.2,18445,196,64,-1355,-1403,19.6,1735.8
4494596077,1,40,5,1,7,9,6,1,0,1,1,18097,7.0,18058,243,39,811,426,24.3,1809.7,18,6,0,9,7,12,1,1,0,0,17286,6.6,17632,194,59,-811,-426,19.4,1728.6
4464132605,1,15,2,0,4,3,2,2,1,1,0,15517,6.8,17441,215,52,697,951,21.5,1551.7,12,3,1,3,4,3,0,0,0,0,14820,6.8,16490,211,48,-697,-951,21.1,1482.0
4495755688,1,16,3,1,8,5,7,1,1,0,0,18020,7.2,18981,253,56,2533,1172,25.3,1802.0,15,6,0,5,8,4,0,0,0,0,15487,6.8,17809,212,60,-2533,-1172,21.2,1548.7
4524183803,1,15,1,0,9,8,9,0,0,0,0,16872,7.0,17906,199,36,-1232,-272,19.9,1687.2,17,1,1,8,9,6,1,1,0,0,18104,7.0,18178,225,48,1232,272,22.5,1810.4
4465992813,1,17,1,1,7,4,9,0,0,0,0,17180,7.0,17511,219,46,1618,934,21.9,1718.0,16,3,0,4,7,5,1,1,0,0,15562,6.8,16577,195,60,-1618,-934,19.5,1556.2
4505809782,1,37,0,0,10,5,15,1,1,0,0,18786,7.2,18509,235,60,2480,1699,23.5,1878.6,15,1,1,5,10,8,1,0,1,0,16306,6.8,16810,221,40,-2480,-1699,22.1,1630.6
4525140164,1,14,2,1,8,9,7,0,0,0,0,17047,7.0,17601,200,47,-97,165,20.0,1704.7,16,3,0,9,8,6,1,1,0,0,17144,6.8,17436,198,48,97,-165,19.8,1714.4
4439587342,1,24,8,0,4,5,3,0,0,0,0,15597,7.0,18695,238,61,-1366,-242,23.8,1559.7,27,6,1,5,4,3,1,1,0,0,16963,7.2,18937,266,50,1366,242,26.6,1696.3
4517599722,1,16,1,1,8,5,9,1,1,0,0,16779,7.0,18171,224,43,1468,195,22.4,1677.9,24,4,0,5,8,4,1,0,1,0,15311,7.0,17976,212,44,-1468,-195,21.2,1531.1
4522430578,1,36,3,0,14,7,5,2,1,1,0,18135,7.0,19550,198,56,1490,1854,19.8,1813.5,11,0,1,7,14,7,0,0,0,0,16645,7.0,17696,180,43,-1490,-1854,18.0,1664.5
4446171042,1,16,4,1,8,4,7,0,0,0,0,17863,7.2,19086,256,33,2590,1850,25.6,1786.3,13,5,0,4,8,4,0,0,0,0,15273,7.0,17236,218,48,-2590,-1850,21.8,1527.3
4499739655,1,16,5,1,6,4,6,0,0,0,0,18072,7.2,19281,281,46,3018,1320,28.1,1807.2,17,4,0,4,6,2,1,1,0,0,15054,7.0,17961,223,58,-3018,-1320,22.3,1505.4
4482423857,1,14,0,1,13,10,15,0,0,0,0,19366,7.0,18628,229,56,1973,1461,22.9,1936.6,11,2,0,10,13,13,1,1,0,0,17393,6.8,17167,164,43,-1973,-1461,16.4,1739.3
4484040931,1,74,0,0,7,7,5,2,1,1,0,18333,6.8,18853,229,64,1665,1578,22.9,1833.3,13,1,1,7,7,15,0,0,0,0,16668,6.8,17275,181,56,-1665,-1578,18.1,1666.8
4520868488,1,15,3,1,9,3,11,0,0,0,0,17592,7.0,18664,220,41,1411,766,22.0,1759.2,11,1,0,3,9,4,1,1,0,0,16181,7.0,17898,215,62,-1411,-766,21.5,1618.1
4412982614,1,22,6,1,6,10,5,0,0,0,0,16003,6.8,17857,214,52,-1761,-1446,21.4,1600.3,22,4,0,10,6,9,0,0,0,0,17764,7.2,19303,238,32,1761,1446,23.8,1776.4
4526649785,1,14,1,0,7,6,7,1,1,0,0,16553,7.2,19304,205,56,1216,2889,20.5,1655.3,11,2,1,6,7,7,0,0,0,0,15337,6.6,16415,173,44,-1216,-2889,17.3,1533.7
4509353286,1,17,2,0,9,3,8,1,1,0,0,17562,7.0,18512,224,50,1948,764,22.4,1756.2,15,0,1,3,9,6,0,0,0,0,15614,7.0,17748,202,62,-1948,-764,20.2,1561.4
4524799428,1,40,1,1,9,3,7,0,0,0,0,18322,7.4,20963,258,68,4100,4903,25.8,1832.2,38,11,0,3,9,1,0,0,0,0,14222,6.4,16060,204,41,-4100,-4903,20.4,1422.2
4436906182,1,13,1,1,4,6,5,0,0,0,0,15420,6.8,16822,235,41,-1633,-2918,23.5,1542.0,17,2,0,6,4,5,1,0,1,0,17053,7.4,19740,253,52,1633,2918,25.3,1705.3
4446235910,1,23,4,1,13,6,13,0,0,0,0,20329,7.6,20692,264,48,4227,3892,26.4,2032.9,16,5,0,6,13,7,0,0,0,0,16102,6.6,16800,174,40,-4227,-3892,17.4,1610.2
4464534299,1,16,2,1,9,3,13,1,0,1,0,17786,7.4,19357,235,52,3090,1008,23.5,1778.6,17,3,0,3,9,2,1,1,0,0,14696,7.2,18349,215,60,-3090,-1008,21.5,1469.6
4521511498,1,15,0,0,5,7,4,1,1,0,0,15681,6.6,16896,205,50,-1058,-1404,20.5,1568.1,15,2,1,7,5,10,0,0,0,0,16739,7.0,18300,224,49,1058,1404,22.4,1673.9
4513247424,1,22,3,1,6,7,4,0,0,0,0,16956,7.2,19155,242,61,-172,594,24.2,1695.6,17,3,0,7,6,10,1,1,0,0,17128,7.2,18561,213,61,172,-594,21.3,1712.8
4475735084,1,21,6,0,7,4,11,0,0,0,0,17012,7.0,17924,226,35,1595,-63,22.6,1701.2,48,7,1,4,7,3,1,1,0,0,15417,6.8,17987,230,56,-1595,63,23.0,1541.7
4459609583,1,20,2,0,7,3,9,0,0,0,0,17354,7.4,20449,224,63,2301,3412,22.4,1735.4,10,2,1,3,7,4,0,0,0,0,15053,6.6,17037,240,44,-2301,-3412,24.0,1505.3
4524572866,1,21,5,1,7,2,8,0,0,0,0,17314,7.2,18785,207,47,3307,1705,20.7,1731.4,18,1,0,2,7,3,2,1,1,0,14007,7.0,17080,195,48,-3307,-1705,19.5,1400.7
4456461566,1,16,1,1,4,5,4,0,0,0,0,15845,6.8,17682,225,48,463,-8,22.5,1584.5,20,1,0,5,4,5,0,0,0,0,15382,7.0,17690,214,42,-463,8,21.4,1538.2
4527469441,1,16,3,1,8,6,13,0,0,0,0,17672,7.2,18962,245,50,1121,933,24.5,1767.2,34,3,0,6,8,8,1,1,0,0,16551,6.8,18029,238,61,-1121,-933,23.8,1655.1
4499907399,1,20,5,0,5,2,6,0,0,0,0,16029,6.8,17493,234,47,1756,1920,23.4,1602.9,16,2,1,2,5,3,0,0,0,0,14273,6.2,15573,199,49,-1756,-1920,19.9,1427.3
4526023571,1,17,0,0,5,4,8,1,0,1,0,15040,6.8,18066,197,44,-1964,-963,19.7,1504.0,11,1,1,4,5,4,0,0,0,0,17004,7.2,19029,260,72,1964,963,26.0,1700.4
4511388378,1,14,1,1,6,5,8,1,1,0,0,16693,7.0,18416,240,67,1722,1857,24.0,1669.3,13,2,0,5,6,2,0,0,0,0,14971,6.6,16559,193,52,-1722,-1857,19.3,1497.1
4448303779,1,38,3,1,10,2,10,1,0,1,0,18822,7.2,20135,253,59,4577,3717,25.3,1882.2,17,3,0,2,10,2,1,1,0,0,14245,6.6,16418,192,48,-4577,-3717,19.2,1424.5
4526857610,1,42,3,1,10,5,5,0,0,0,0,18036,7.4,19849,243,54,2203,1534,24.3,1803.6,14,4,0,5,10,5,1,1,0,0,15833,7.0,18315,193,72,-2203,-1534,19.3,1583.3
4525567739,1,15,1,0,4,3,5,0,0,0,0,15502,7.0,17716,223,56,243,-31,22.3,1550.2,17,2,1,3,4,5,1,1,0,0,15259,6.8,17747,214,49,-243,31,21.4,1525.9
4522587007,1,17,2,0,4,7,5,0,0,0,0,16171,7.0,18471,240,57,-758,920,24.0,1617.1,12,1,1,7,4,8,0,0,0,0,16929,6.8,17551,208,57,758,-920,20.8,1692.9
4513054107,1,17,1,0,5,5,6,0,0,0,0,16873,7.2,19105,223,64,1389,1418,22.3,1687.3,38,2,1,5,5,7,1,1,0,0,15484,6.8,17687,226,49,-1389,-1418,22.6,1548.4
4511593517,1,22,4,0,8,6,7,1,1,0,0,18070,7.2,19549,237,53,1263,590,23.7,1807.0,50,1,1,6,8,9,0,0,0,0,16807,7.4,18959,205,72,-1263,-590,20.5,1680.7
4464447310,1,20,3,0,11,4,13,1,1,0,0,19716,7.2,19989,234,52,5163,3968,23.4,1971.6,15,0,1,4,11,4,0,0,0,0,14553,6.4,16021,182,51,-5163,-3968,18.2,1455.3
4446530367,1,95,1,1,7,5,14,1,1,0,0,17964,7.2,18073,216,55,4042,4968,21.6,1796.4,11,2,0,5,7,4,0,0,0,0,13922,5.4,13105,172,4,-4042,-4968,17.2,1392.2
4523654573,1,12,3,1,7,4,6,1,1,0,0,17914,7.0,18528,240,62,3410,2524,24.0,1791.4,38,1,0,4,7,7,0,0,0,0,14504,6.4,16004,187,48,-3410,-2524,18.7,1450.4
4475476612,1,159,4,0,8,7,5,0,0,0,0,17321,7.6,19677,238,48,703,477,23.8,1732.1,15,1,1,7,8,6,1,1,0,0,16618,7.2,19200,212,68,-703,-477,21.2,1661.8
4515202068,1,35,2,1,4,4,4,0,0,0,0,15686,7.0,18036,206,52,126,290,20.6,1568.6,14,3,0,4,4,6,0,0,0,0,15560,6.8,17746,224,48,-126,-290,22.4,1556.0
4515575207,1,18,1,1,13,2,11,1,1,0,0,19867,7.0,19401,236,58,6977,5303,23.6,1986.7,13,1,0,2,13,4,0,0,0,0,12890,5.8,14098,168,33,-6977,-5303,16.8,1289.0
4519680477,1,18,2,1,8,3,7,1,1,0,0,17828,7.2,19155,242,65,3642,3850,24.2,1782.8,38,6,0,3,8,3,0,0,0,0,14186,6.2,15305,179,34,-3642,-3850,17.9,1418.6
4455725708,1,13,2,1,12,10,10,1,1,0,0,18913,7.2,19076,183,55,1051,12,18.3,1891.3,13,0,0,10,12,7,0,0,0,0,17862,7.2,19064,209,40,-1051,-12,20.9,1786.2
4519754998,1,27,1,1,6,5,4,0,0,0,0,16789,7.0,19024,218,72,959,917,21.8,1678.9,17,3,0,5,6,5,1,1,0,0,15830,7.0,18107,213,52,-959,-917,21.3,1583.0
4503426918,1,47,3,0,9,3,10,1,0,1,0,16795,7.4,19175,203,41,2011,2996,20.3,1679.5,88,1,1,3,9,3,1,1,0,0,14784,6.6,16179,202,46,-2011,-2996,20.2,1478.4
4524542194,1,21,3,1,9,9,11,1,1,0,0,17489,6.6,16724,221,40,-219,-1275,22.1,1748.9,40,5,0,9,9,13,0,0,0,0,17708,6.8,17999,226,44,219,1275,22.6,1770.8
4456927812,1,17,1,1,8,1,9,1,1,0,0,18177,7.4,19922,256,48,3710,2326,25.6,1817.7,16,2,0,1,8,2,0,0,0,0,14467,7.0,17596,226,58,-3710,-2326,22.6,1446.7
4524768986,1,16,2,1,12,10,13,1,1,0,0,19622,7.0,18338,216,54,1997,-800,21.6,1962.2,16,2,0,10,12,8,0,0,0,0,17625,7.0,19138,211,56,-1997,800,21.1,1762.5
4520910762,1,14,1,1,3,3,3,1,1,0,0,16769,7.2,19760,257,76,1316,1233,25.7,1676.9,17,2,0,3,3,4,0,0,0,0,15453,7.2,18527,241,53,-1316,-1233,24.1,1545.3
4502709604,1,11,2,0,6,7,8,1,0,1,0,17192,7.0,18065,221,56,662,44,22.1,1719.2,14,2,1,7,6,6,1,1,0,0,16530,6.8,18021,196,51,-662,-44,19.6,1653.0
4525245077,1,24,4,1,10,7,11,2,1,1,0,18256,7.0,18201,186,58,1489,-192,18.6,1825.6,17,3,0,7,10,7,0,0,0,0,16767,7.0,18393,247,28,-1489,192,24.7,1676.7
4521542696,1,13,0,1,9,4,6,0,0,0,0,18189,7.0,19191,220,54,3905,3713,22.0,1818.9,15,3,0,4,9,3,0,0,0,0,14284,6.2,15478,181,52,-3905,-3713,18.1,1428.4
4464799134,1,19,4,1,12,5,9,0,0,0,0,19143,7.4,20064,243,36,3469,3684,24.3,1914.3,18,3,0,5,12,8,1,1,0,0,15674,6.6,16380,199,47,-3469,-3684,19.9,1567.4
4504166210,1,250,4,1,12,10,12,1,0,1,0,19704,7.0,18253,209,44,3067,503,20.9,1970.4,16,1,0,10,12,6,1,1,0,0,16637,6.8,17750,174,56,-3067,-503,17.4,1663.7
4526544646,1,14,1,0,6,7,8,1,1,0,0,16871,6.8,17798,263,40,-89,-144,26.3,1687.1,40,3,1,7,6,13,0,0,0,0,16960,7.2,17942,232,36,89,144,23.2,1696.0
4513310043,1,18,7,1,7,8,3,0,0,0,0,16863,6.8,17725,206,42,783,-301,20.6,1686.3,18,5,0,8,7,7,1,1,0,0,16080,7.0,18026,186,44,-783,301,18.6,1608.0
4520639999,1,40,1,0,5,3,5,0,0,0,0,16418,7.2,19182,242,60,1234,962,24.2,1641.8,18,14,1,3,5,3,2,1,1,0,15184,6.8,18220,215,56,-1234,-962,21.5,1518.4
4490516014,1,16,2,1,6,7,9,1,0,1,0,16512,7.4,18547,207,75,-1314,-1027,20.7,1651.2,39,2,0,7,6,10,1,1,0,0,17826,7.2,19574,246,67,1314,1027,24.6,1782.6
4500647186,1,33,4,1,4,2,4,1,1,0,0,16607,7.0,19014,261,68,2261,1906,26.1,1660.7,16,5,0,2,4,0,0,0,0,0,14346,6.6,17108,221,52,-2261,-1906,22.1,1434.6
4510666820,1,41,1,1,12,5,18,1,1,0,0,18567,7.0,18176,227,40,1526,472,22.7,1856.7,17,1,0,5,12,7,0,0,0,0,17041,6.8,17704,203,56,-1526,-472,20.3,1704.1
4518930107,1,14,0,1,5,7,4,0,0,0,0,15637,6.6,16107,201,50,-460,-842,20.1,1563.7,19,1,0,7,5,9,0,0,0,0,16097,6.8,16949,218,31,460,842,21.8,1609.7
4524502451,1,16,3,1,4,4,3,1,1,0,0,15620,7.0,17974,225,52,234,-318,22.5,1562.0,89,2,0,4,4,4,0,0,0,0,15386,7.0,18292,227,40,-234,318,22.7,1538.6
4515825606,1,10,4,1,7,5,4,0,0,0,0,16478,7.0,18363,224,71,707,-788,22.4,1647.8,16,1,0,5,7,3,1,1,0,0,15771,7.2,19151,225,60,-707,788,22.5,1577.1
4505362087,1,11,2,0,10,6,7,0,0,0,0,18129,7.2,19644,230,60,2428,2186,23.0,1812.9,37,2,1,6,10,9,1,1,0,0,15701,6.8,17458,212,55,-2428,-2186,21.2,1570.1
4526346248,1,11,0,1,5,5,5,0,0,0,1,17803,7.0,18782,242,52,2197,1516,24.2,1780.3,13,1,0,5,5,8,0,0,0,0,15606,6.8,17266,228,37,-2197,-1516,22.8,1560.6
4513445048,1,15,3,1,8,4,10,1,1,0,0,18341,7.4,19070,217,76,3311,2682,21.7,1834.1,14,0,0,4,8,3,0,0,0,0,15030,6.6,16388,228,44,-3311,-2682,22.8,1503.0
4503476670,1,19,3,1,4,4,3,0,0,0,0,16621,6.8,18305,255,50,875,-391,25.5,1662.1,15,4,0,4,4,7,0,0,0,0,15746,7.0,18696,238,65,-875,391,23.8,1574.6
4468469648,1,18,1,1,14,7,13,1,0,1,0,18802,6.8,18463,213,35,2393,675,21.3,1880.2,9,3,0,7,14,6,1,1,0,0,16409,6.8,17788,206,59,-2393,-675,20.6,1640.9
4465004748,1,18,1,0,8,4,10,2,1,1,0,16993,7.2,18608,212,48,937,530,21.2,1699.3,19,3,1,4,8,3,0,0,0,0,16056,7.0,18078,205,66,-937,-530,20.5,1605.6
4525242680,1,16,3,0,4,11,3,1,1,0,0,15786,6.6,17495,217,55,-4406,-2504,21.7,1578.6,20,5,1,11,4,15,0,0,0,1,20192,7.2,19999,233,68,4406,2504,23.3,2019.2
4446243794,1,16,4,0,1,5,1,2,1,1,0,14942,7.0,17727,210,83,-1215,-756,21.0,1494.2,21,3,1,5,1,7,0,0,0,0,16157,7.0,18483,233,52,1215,756,23.3,1615.7
4508648783,1,12,2,1,11,5,7,2,1,1,0,18576,7.2,20102,227,59,2276,1971,22.7,1857.6,15,1,0,5,11,6,0,0,0,0,16300,7.0,18131,213,67,-2276,-1971,21.3,1630.0
4518849828,1,13,1,1,7,4,6,2,1,1,0,17237,7.2,18352,196,56,1346,849,19.6,1723.7,17,2,0,4,7,3,0,0,0,0,15891,6.8,17503,241,45,-1346,-849,24.1,1589.1
4435697365,1,17,2,1,5,2,5,2,1,1,0,17446,7.4,20350,255,63,3229,3548,25.5,1744.6,14,2,0,2,5,2,0,0,0,0,14217,6.6,16802,221,48,-3229,-3548,22.1,1421.7
4450110737,1,146,5,1,13,9,13,1,1,0,0,19929,7.6,20672,224,67,2558,2349,22.4,1992.9,38,1,0,9,13,14,0,0,0,0,17371,7.2,18323,208,38,-2558,-2349,20.8,1737.1
4511761586,1,45,5,0,6,7,8,1,1,0,0,17046,7.4,19783,217,67,307,2085,21.7,1704.6,16,7,1,7,6,7,0,0,0,0,16739,7.0,17698,256,40,-307,-2085,25.6,1673.9
4467033955,1,15,5,1,8,4,7,1,0,1,0,18837,7.6,20066,246,48,3479,2657,24.6,1883.7,54,4,0,4,8,6,1,1,0,0,15358,6.8,17409,222,55,-3479,-2657,22.2,1535.8
4495172463,1,12,0,0,4,6,5,0,0,0,0,15154,6.6,17363,170,56,-2642,-1908,17.0,1515.4,16,2,1,6,4,7,1,1,0,0,17796,7.2,19271,258,64,2642,1908,25.8,1779.6
4459583409,1,25,7,0,4,6,4,1,1,0,0,15883,6.8,17317,235,53,-426,-323,23.5,1588.3,17,4,1,6,4,6,0,0,0,0,16309,7.0,17640,238,42,426,323,23.8,1630.9
4455180442,1,14,13,1,12,3,10,1,1,0,0,19537,7.8,20680,246,51,4932,3923,24.6,1953.7,40,1,0,3,12,2,0,0,0,0,14605,6.6,16757,212,48,-4932,-3923,21.2,1460.5
4527291064,1,13,1,1,10,1,15,0,0,0,0,18697,7.2,19162,237,36,4695,2313,23.7,1869.7,11,1,0,1,10,1,0,0,0,0,14002,6.4,16849,235,44,-4695,-2313,23.5,1400.2
4474787155,1,12,2,0,7,2,7,1,0,1,0,17731,7.6,20617,238,80,3339,3179,23.8,1773.1,11,1,1,2,7,2,1,1,0,0,14392,6.8,17438,236,46,-3339,-3179,23.6,1439.2
4526851533,1,66,2,1,8,1,8,1,1,0,0,16853,7.0,18255,226,44,2751,1464,22.6,1685.3,12,2,0,1,8,0,0,0,0,0,14102,6.8,16791,199,57,-2751,-1464,19.9,1410.2
4475988049,1,52,1,1,10,5,11,0,0,0,0,17741,6.8,18253,230,40,2405,1439,23.0,1774.1,12,5,0,5,10,6,1,1,0,0,15336,6.8,16814,199,40,-2405,-1439,19.9,1533.6
4511896350,1,37,0,0,6,4,8,0,0,0,0,16463,7.2,18961,221,60,354,816,22.1,1646.3,15,1,1,4,6,1,0,0,0,0,16109,7.0,18145,225,48,-354,-816,22.5,1610.9
4464569523,1,20,5,1,8,5,11,1,1,0,0,17366,7.0,17659,229,46,1074,52,22.9,1736.6,18,5,0,5,8,3,0,0,0,0,16292,6.8,17607,245,34,-1074,-52,24.5,1629.2
4526211011,1,14,2,0,5,7,4,0,0,0,0,15553,6.6,15768,203,40,-977,-2180,20.3,1555.3,17,0,1,7,5,5,2,1,1,0,16530,7.0,17948,222,54,977,2180,22.2,1653.0
4512326355,1,12,2,1,12,5,11,2,1,1,0,18882,6.6,18137,202,57,3807,1849,20.2,1888.2,14,1,0,5,12,9,0,0,0,0,15075,6.8,16288,187,52,-3807,-1849,18.7,1507.5
4521886513,1,42,2,1,7,2,10,1,1,0,0,17267,7.2,18482,224,44,3107,2096,22.4,1726.7,16,5,0,2,7,0,0,0,0,0,14160,6.6,16386,218,40,-3107,-2096,21.8,1416.0
4526285141,1,20,1,0,5,4,3,1,1,0,0,16517,6.8,17812,246,49,819,-48,24.6,1651.7,13,3,1,4,5,4,0,0,0,0,15698,7.2,17860,245,57,-819,48,24.5,1569.8
4522564932,1,81,2,0,6,3,4,0,0,0,0,18314,7.6,21257,257,76,3274,3262,25.7,1831.4,44,0,1,3,6,3,1,1,0,0,15040,7.0,17995,195,72,-3274,-3262,19.5,1504.0
4463280330,1,18,2,0,9,9,6,1,1,0,0,18137,7.0,19154,218,62,201,1596,21.8,1813.7,17,3,1,9,9,14,0,0,0,0,17936,6.6,17558,197,61,-201,-1596,19.7,1793.6
4514117878,1,22,8,1,7,2,9,1,1,0,0,18021,7.2,19353,246,50,4957,4440,24.6,1802.1,50,2,0,2,7,2,0,0,0,0,13064,6.4,14913,182,45,-4957,-4440,18.2,1306.4
4521220052,1,14,1,1,7,4,2,1,1,0,0,15924,7.0,17965,211,45,961,1114,21.1,1592.4,13,2,0,4,7,3,0,0,0,0,14963,6.6,16851,199,38,-961,-1114,19.9,1496.3
4518123913,1,15,2,1,7,2,9,0,0,0,0,17773,7.6,20821,242,67,2421,3009,24.2,1777.3,38,2,0,2,7,2,0,0,0,0,15352,7.0,17812,221,64,-2421,-3009,22.1,1535.2
4523446704,1,17,2,1,4,4,4,0,0,0,0,15296,6.6,17179,221,40,-112,-812,22.1,1529.6,14,3,0,4,4,4,1,1,0,0,15408,6.8,17991,222,50,112,812,22.2,1540.8
4511606609,1,27,6,1,7,7,4,0,0,0,0,17309,7.2,19092,253,48,763,1025,25.3,1730.9,17,1,0,7,7,9,1,1,0,0,16546,7.0,18067,217,48,-763,-1025,21.7,1654.6
4497565171,1,10,4,1,13,5,18,1,1,0,1,20853,7.4,20447,251,49,5477,3692,25.1,2085.3,14,2,0,5,13,4,0,0,0,0,15376,6.6,16755,206,46,-5477,-3692,20.6,1537.6
4491170236,1,17,3,0,6,9,6,0,0,0,0,16407,7.4,18871,168,67,-949,-297,16.8,1640.7,68,5,1,9,6,3,1,1,0,0,17356,7.2,19168,216,53,949,297,21.6,1735.6
4499967324,1,17,3,1,6,4,7,0,0,0,0,17477,7.0,19006,232,64,1814,73,23.2,1747.7,14,0,0,4,6,4,1,1,0,0,15663,7.0,18933,210,72,-1814,-73,21.0,1566.3
4515649293,1,13,1,1,4,8,8,0,0,0,0,15352,6.4,15672,193,46,-1702,-1490,19.3,1535.2,15,1,0,8,4,13,1,1,0,0,17054,6.6,17162,191,44,1702,1490,19.1,1705.4
4520341861,1,17,4,0,1,8,0,1,1,0,0,13493,6.6,16560,218,44,-3700,-2221,21.8,1349.3,16,5,1,8,1,8,0,0,0,0,17193,7.0,18781,229,39,3700,2221,22.9,1719.3
4457404294,1,16,5,1,17,10,25,0,0,0,1,23335,7.6,20839,239,52,6790,5348,23.9,2333.5,14,0,0,10,17,11,0,0,0,0,16545,6.4,15491,129,26,-6790,-5348,12.9,1654.5
4526405689,1,12,2,1,7,2,8,0,0,0,0,17479,7.0,18923,246,41,2305,482,24.6,1747.9,16,1,0,2,7,0,2,1,1,0,15174,7.2,18441,226,72,-2305,-482,22.6,1517.4
4458389228,1,20,5,1,11,8,9,0,0,0,0,18746,7.2,19066,225,44,2198,1355,22.5,1874.6,18,1,0,8,11,4,1,1,0,0,16548,6.8,17711,204,64,-2198,-1355,20.4,1654.8
4502966435,1,16,3,1,4,4,1,1,0,1,0,16516,7.4,19168,259,60,1234,1855,25.9,1651.6,9,2,0,4,4,5,0,0,0,0,15282,6.8,17313,229,44,-1234,-1855,22.9,1528.2
4515405283,1,17,1,1,9,2,5,0,0,0,0,17777,7.4,19414,238,48,3361,3545,23.8,1777.7,13,4,0,2,9,1,0,0,0,0,14416,6.4,15869,208,44,-3361,-3545,20.8,1441.6
4493017629,1,21,3,1,4,4,3,0,0,0,0,16297,6.8,17730,237,62,1772,1255,23.7,1629.7,17,1,0,4,4,4,0,0,0,0,14525,6.6,16475,202,36,-1772,-1255,20.2,1452.5
4501459269,1,12,5,1,8,9,15,0,0,0,0,18315,7.0,18534,209,51,246,1266,20.9,1831.5,17,0,0,9,8,8,1,1,0,0,18069,6.8,17268,208,46,-246,-1266,20.8,1806.9
4525837702,1,22,9,1,7,1,12,1,1,0,0,17696,7.2,18389,223,55,3650,2712,22.3,1769.6,19,6,0,1,7,1,0,0,0,0,14046,6.2,15677,237,32,-3650,-2712,23.7,1404.6
4521135230,1,16,1,1,8,1,8,1,1,0,0,17613,7.2,19092,234,48,3949,2440,23.4,1761.3,40,3,0,1,8,2,0,0,0,0,13664,6.6,16652,216,44,-3949,-2440,21.6,1366.4
4518710301,1,35,4,0,4,9,1,0,0,0,0,14621,7.0,17862,179,62,-3644,-1277,17.9,1462.1,15,0,1,9,4,12,1,1,0,0,18265,7.0,19139,243,44,3644,1277,24.3,1826.5
4525367812,1,17,5,0,1,4,0,0,0,0,0,14334,7.0,18293,242,52,-1878,-178,24.2,1433.4,22,2,1,4,1,6,1,1,0,0,16212,7.0,18471,262,56,1878,178,26.2,1621.2
4516853831,1,47,4,1,9,9,18,0,0,0,0,17284,6.2,15506,182,42,550,-371,18.2,1728.4,17,2,0,9,9,15,0,0,0,0,16734,6.6,15877,192,44,-550,371,19.2,1673.4
4491456543,1,20,5,1,10,1,15,1,1,0,0,18795,7.4,20241,260,43,4498,3370,26.0,1879.5,22,3,0,1,10,2,0,0,0,0,14297,6.4,16871,226,48,-4498,-3370,22.6,1429.7
4448358133,1,20,0,1,5,7,9,0,0,0,0,16072,6.8,16945,236,32,-184,408,23.6,1607.2,12,5,0,7,5,7,0,0,0,0,16256,6.8,16537,195,39,184,-408,19.5,1625.6
4500339262,1,12,2,1,7,4,7,1,0,1,0,18821,7.2,19339,259,68,4074,2842,25.9,1882.1,13,1,0,4,7,6,0,0,0,0,14747,6.4,16497,189,36,-4074,-2842,18.9,1474.7
4467354917,1,22,0,0,6,5,6,1,1,0,0,16273,7.2,19013,237,44,464,1383,23.7,1627.3,14,5,1,5,6,2,1,0,1,0,15809,7.0,17630,235,43,-464,-1383,23.5,1580.9
4478167956,1,13,1,0,14,2,19,1,1,0,0,19133,7.2,19406,200,56,4531,2978,20.0,1913.3,12,2,1,2,14,3,0,0,0,0,14602,6.6,16428,211,60,-4531,-2978,21.1,1460.2
4427497326,1,19,2,1,8,6,11,0,0,0,0,17483,7.2,18392,215,36,1232,-128,21.5,1748.3,16,6,0,6,8,7,0,0,0,0,16251,7.2,18520,233,48,-1232,128,23.3,1625.1
4519035027,1,13,2,0,3,4,1,1,1,0,0,15115,7.2,19609,219,72,-90,982,21.9,1511.5,18,1,1,4,3,1,1,0,1,0,15205,7.2,18627,213,44,90,-982,21.3,1520.5
4447227454,1,14,1,1,5,2,7,1,1,0,0,16443,7.0,18538,238,48,1717,508,23.8,1644.3,12,0,0,2,5,4,0,0,0,0,14726,7.0,18030,197,60,-1717,-508,19.7,1472.6
4517169026,1,11,1,1,11,5,12,2,1,1,1,19696,7.2,18881,222,48,3802,1762,22.2,1969.6,21,0,0,5,11,6,0,0,0,0,15894,6.8,17119,209,60,-3802,-1762,20.9,1589.4
4524160541,1,115,3,1,11,4,8,1,0,1,1,20176,7.6,19773,260,55,5830,1979,26.0,2017.6,25,1,0,4,11,0,0,0,0,0,14346,6.8,17794,194,52,-5830,-1979,19.4,1434.6
4495935822,1,20,4,0,7,5,8,0,0,0,0,16747,6.8,18344,198,40,1058,1735,19.8,1674.7,19,8,1,5,7,9,1,1,0,0,15689,6.6,16609,198,46,-1058,-1735,19.8,1568.9
4511994182,1,15,0,0,11,5,9,1,1,0,1,19632,7.0,18732,222,60,4648,2498,22.2,1963.2,12,0,1,5,11,7,0,0,0,0,14984,6.4,16234,181,37,-4648,-2498,18.1,1498.4
4525171527,1,16,1,1,6,3,6,1,1,0,0,14887,6.4,14486,159,36,-498,-2244,15.9,1488.7,17,3,0,3,6,1,1,0,1,0,15385,6.6,16730,227,56,498,2244,22.7,1538.5
4420829528,1,20,7,0,11,4,12,0,0,0,0,19392,7.2,18570,239,48,4872,3076,23.9,1939.2,20,3,1,4,11,6,0,0,0,0,14520,6.2,15494,203,34,-4872,-3076,20.3,1452.0
4518452503,1,16,3,1,9,5,10,1,1,0,0,16819,6.8,17163,197,40,459,-1147,19.7,1681.9,13,4,0,5,9,3,1,0,1,0,16360,6.8,18310,235,57,-459,1147,23.5,1636.0
4458863956,1,58,1,1,10,2,17,1,1,0,1,19483,7.0,18561,211,56,5415,2991,21.1,1948.3,16,1,0,2,10,4,0,0,0,0,14068,6.4,15570,203,48,-5415,-2991,20.3,1406.8
4526103377,1,86,2,0,5,6,7,0,0,0,0,16123,6.8,17612,203,60,569,304,20.3,1612.3,15,2,1,6,5,4,1,1,0,0,15554,6.8,17308,181,60,-569,-304,18.1,1555.4
4454291477,1,15,0,0,5,10,1,0,0,0,0,15605,7.0,19324,216,58,-2048,-29,21.6,1560.5,12,0,1,10,5,13,1,1,0,0,17653,7.4,19353,221,52,2048,29,22.1,1765.3
4526952901,1,12,7,1,6,5,3,2,1,1,1,17948,7.0,18736,247,48,2435,894,24.7,1794.8,18,1,0,5,6,7,0,0,0,0,15513,6.8,17842,219,35,-2435,-894,21.9,1551.3
4518570301,1,17,2,1,2,4,4,1,0,1,0,15565,6.4,17312,251,64,-1185,-2402,25.1,1556.5,21,2,0,4,2,8,1,1,0,0,16750,7.4,19714,267,62,1185,2402,26.7,1675.0
4500544230,1,14,3,1,5,4,3,1,1,0,0,16490,7.0,18411,214,55,1018,-1023,21.4,1649.0,13,0,0,4,5,2,1,0,1,0,15472,7.2,19434,204,64,-1018,1023,20.4,1547.2
4526275078,1,15,4,0,7,3,6,1,1,0,0,18038,7.2,19458,240,64,3973,3481,24.0,1803.8,14,1,1,3,7,1,0,0,0,0,14065,6.6,15977,195,48,-3973,-3481,19.5,1406.5
4494055420,1,15,5,0,8,7,8,1,0,1,0,16463,6.4,16544,186,40,-460,-1189,18.6,1646.3,18,3,1,7,8,4,0,0,0,0,16923,6.8,17733,238,48,460,1189,23.8,1692.3
4526620130,1,13,7,1,10,2,9,2,1,1,0,18137,7.0,18171,231,44,3807,1830,23.1,1813.7,14,4,0,2,10,3,0,0,0,0,14330,6.6,16341,204,43,-3807,-1830,20.4,1433.0
4480206299,1,23,3,1,9,7,12,1,0,1,0,17836,7.2,19027,214,64,969,1554,21.4,1783.6,18,3,0,7,9,7,1,1,0,0,16867,6.8,17473,216,36,-969,-1554,21.6,1686.7
4500036039,1,18,2,1,6,3,10,0,0,0,0,16299,7.0,17994,234,45,1049,-291,23.4,1629.9,35,3,0,3,6,1,0,0,0,0,15250,7.0,18285,240,51,-1049,291,24.0,1525.0
4482389592,1,16,3,0,7,5,9,1,1,0,0,16460,7.0,18782,222,52,192,616,22.2,1646.0,52,1,1,5,7,8,0,0,0,0,16268,7.2,18166,236,46,-192,-616,23.6,1626.8
4523788727,1,13,1,1,12,9,18,0,0,0,0,18748,6.8,17354,195,45,1212,77,19.5,1874.8,13,1,0,9,12,8,1,1,0,0,17536,7.0,17277,193,52,-1212,-77,19.3,1753.6
4525010648,1,37,1,0,10,8,10,0,0,0,0,18588,7.2,19735,225,64,2382,2614,22.5,1858.8,16,1,1,8,10,7,0,0,0,0,16206,6.8,17121,192,28,-2382,-2614,19.2,1620.6
4505369566,1,13,6,1,13,3,19,1,1,0,2,21872,7.2,19671,225,36,7404,5156,22.5,2187.2,14,0,0,3,13,3,0,0,0,0,14468,6.2,14515,169,50,-7404,-5156,16.9,1446.8
4518075539,1,20,3,0,7,8,5,1,0,1,0,16294,6.8,17489,182,58,-1318,-627,18.2,1629.4,17,3,1,8,7,7,0,0,0,0,17612,6.8,18116,237,44,1318,627,23.7,1761.2
4507610115,1,16,2,1,6,0,7,0,0,0,0,16144,7.0,18236,199,49,1594,477,19.9,1614.4,37,2,0,0,6,0,1,1,0,0,14550,7.0,17759,257,60,-1594,-477,25.7,1455.0
4519054552,1,15,4,0,11,4,12,0,0,0,0,18733,7.4,19592,201,62,3925,4105,20.1,1873.3,15,0,1,4,11,9,1,1,0,0,14808,6.4,15487,179,44,-3925,-4105,17.9,1480.8
4502653498,1,16,4,0,6,6,12,1,1,0,0,16618,6.8,17463,192,54,1354,1326,19.2,1661.8,16,3,1,6,6,12,0,0,0,0,15264,6.6,16137,203,31,-1354,-1326,20.3,1526.4
4526830750,1,19,3,0,7,6,12,1,1,0,0,17737,7.0,18873,220,48,1126,549,22.0,1773.7,51,0,1,6,7,10,0,0,0,0,16611,7.2,18324,228,55,-1126,-549,22.8,1661.1
4509589971,1,41,5,1,8,5,7,1,1,0,0,17209,7.2,18853,219,54,2481,1962,21.9,1720.9,18,3,0,5,8,3,0,0,0,0,14728,6.8,16891,195,46,-2481,-1962,19.5,1472.8
4519232603,1,15,4,1,11,6,21,1,1,0,0,17597,6.8,17045,190,50,2534,2539,19.0,1759.7,12,1,0,6,11,5,0,0,0,0,15063,6.2,14506,188,32,-2534,-2539,18.8,1506.3
4521191385,1,13,4,1,8,2,10,0,0,0,0,17754,7.0,18653,239,39,3880,2784,23.9,1775.4,18,2,0,2,8,1,0,0,0,0,13874,6.4,15869,204,40,-3880,-2784,20.4,1387.4
4466040137,1,57,3,0,11,9,13,0,0,0,0,18333,7.0,18622,225,56,736,266,22.5,1833.3,15,2,1,9,11,9,1,1,0,0,17597,7.2,18356,205,44,-736,-266,20.5,1759.7
4493375568,1,14,1,1,6,4,5,0,0,0,0,16600,7.0,18970,208,60,735,161,20.8,1660.0,14,1,0,4,6,0,1,1,0,0,15865,7.2,18809,252,64,-735,-161,25.2,1586.5
4518364742,1,17,3,1,6,0,3,1,1,0,0,17816,7.2,20228,244,61,4677,4588,24.4,1781.6,13,1,0,0,6,0,0,0,0,0,13139,6.6,15640,216,39,-4677,-4588,21.6,1313.9
4516786355,1,16,3,1,5,6,8,1,0,1,0,15927,6.6,17498,220,58,-412,-609,22.0,1592.7,16,3,0,6,5,8,1,1,0,0,16339,6.6,18107,234,37,412,609,23.4,1633.9
4520974128,1,13,2,1,8,5,10,1,1,0,0,17667,7.4,19486,237,48,2461,1779,23.7,1766.7,15,2,0,5,8,6,0,0,0,0,15206,6.8,17707,217,36,-2461,-1779,21.7,1520.6
4512774492,1,50,4,1,6,4,8,2,1,1,0,16248,6.8,17200,200,52,1463,1490,20.0,1624.8,48,2,0,4,6,8,0,0,0,0,14785,6.6,15710,169,52,-1463,-1490,16.9,1478.5
4511011052,1,37,4,0,19,3,25,0,0,0,1,23278,7.8,22125,240,48,8667,7645,24.0,2327.8,15,3,1,3,19,7,0,0,0,0,14611,6.2,14480,189,46,-8667,-7645,18.9,1461.1
4467269037,1,21,4,1,5,1,6,1,1,0,0,16956,7.2,18750,259,56,1723,740,25.9,1695.6,14,2,0,1,5,1,1,0,1,0,15233,6.8,18010,262,64,-1723,-740,26.2,1523.3
4481963149,1,12,2,0,9,2,8,1,1,0,0,17378,7.4,19405,253,44,3268,2650,25.3,1737.8,15,3,1,2,9,3,0,0,0,0,14110,6.4,16755,212,52,-3268,-2650,21.2,1411.0
4509979337,1,14,0,0,4,7,1,0,0,0,0,14924,6.8,17139,207,56,-2611,-1375,20.7,1492.4,54,0,1,7,4,5,1,1,0,1,17535,7.0,18514,218,65,2611,1375,21.8,1753.5
4500088034,1,17,3,0,4,6,2,1,0,1,0,15374,6.8,17943,223,49,-780,107,22.3,1537.4,18,3,1,6,4,6,1,1,0,0,16154,7.2,17836,231,61,780,-107,23.1,1615.4
4518369652,1,16,6,1,7,5,6,1,0,1,0,16887,7.0,18500,212,39,1564,1214,21.2,1688.7,63,4,0,5,7,5,1,1,0,0,15323,6.6,17286,200,47,-1564,-1214,20.0,1532.3
4498589837,1,16,2,1,5,4,5,2,1,1,0,16548,6.8,18505,226,64,780,523,22.6,1654.8,32,2,0,4,5,5,0,0,0,0,15768,7.0,17982,226,52,-780,-523,22.6,1576.8
4496622570,1,17,1,0,7,8,3,1,0,1,0,16653,7.0,17618,227,40,23,306,22.7,1665.3,12,1,1,8,7,8,0,0,0,0,16630,7.0,17312,193,48,-23,-306,19.3,1663.0
4523411488,1,20,1,1,9,7,15,1,1,0,0,16541,6.6,16779,199,37,-146,-717,19.9,1654.1,12,3,0,7,9,8,1,0,1,0,16687,6.8,17496,225,44,146,717,22.5,1668.7
4459271455,1,14,4,0,13,6,19,1,0,1,0,20617,7.4,19936,240,56,3183,1321,24.0,2061.7,19,1,1,6,13,7,1,1,0,0,17434,7.0,18615,235,72,-3183,-1321,23.5,1743.4
4495787574,1,15,2,0,12,5,16,2,1,1,1,19572,7.0,18020,213,40,3987,1169,21.3,1957.2,14,1,1,5,12,6,0,0,0,0,15585,6.6,16851,193,40,-3987,-1169,19.3,1558.5
4526825925,1,17,5,1,7,7,5,1,1,0,0,16825,7.4,19699,229,48,389,1652,22.9,1682.5,42,1,0,7,7,8,1,0,1,0,16436,7.0,18047,194,47,-389,-1652,19.4,1643.6
4527040336,1,16,6,1,5,4,5,0,0,0,0,15452,6.6,16236,195,35,926,-849,19.5,1545.2,17,2,0,4,5,4,1,1,0,0,14526,6.8,17085,186,44,-926,849,18.6,1452.6
4524458385,1,16,7,1,5,5,5,0,0,0,0,15722,6.8,16349,222,34,679,471,22.2,1572.2,16,3,0,5,5,5,0,0,0,0,15043,6.4,15878,181,48,-679,-471,18.1,1504.3
4515533339,1,16,2,0,5,12,6,0,0,0,0,16177,6.8,17721,214,56,-2281,-1283,21.4,1617.7,12,2,1,12,5,12,1,1,0,0,18458,7.2,19004,229,52,2281,1283,22.9,1845.8
4489894297,1,20,5,0,6,2,4,1,0,1,0,17528,7.2,20077,257,64,2605,2260,25.7,1752.8,16,4,1,2,6,3,1,1,0,0,14923,6.8,17817,254,51,-2605,-2260,25.4,1492.3
4495217197,1,19,5,1,5,0,4,1,1,0,0,16797,7.2,19788,268,55,2234,1897,26.8,1679.7,19,5,0,0,5,0,0,0,0,0,14563,6.8,17891,273,57,-2234,-1897,27.3,1456.3
4459259003,1,19,4,1,10,1,7,0,0,0,0,18152,7.2,19147,233,47,4263,2953,23.3,1815.2,16,3,0,1,10,2,1,0,1,0,13889,6.6,16194,204,55,-4263,-2953,20.4,1388.9
4522010330,1,11,2,1,9,3,8,0,0,0,1,18870,7.0,18880,232,57,5014,3238,23.2,1887.0,10,1,0,3,9,5,0,0,0,0,13856,6.2,15642,173,50,-5014,-3238,17.3,1385.6
4495464440,1,15,2,0,3,8,4,0,0,0,0,14398,6.6,15990,194,42,-2919,-2318,19.4,1439.8,16,2,1,8,3,9,1,1,0,0,17317,7.0,18308,207,51,2919,2318,20.7,1731.7
4515376975,1,11,3,0,4,6,5,1,0,1,0,16697,7.0,19148,233,69,601,-303,23.3,1669.7,42,5,1,6,4,9,1,1,0,0,16096,7.2,19451,230,53,-601,303,23.0,1609.6
4527243776,1,17,6,1,7,1,11,1,1,0,0,17709,7.2,19221,242,52,3324,1398,24.2,1770.9,29,4,0,1,7,0,1,0,1,0,14385,6.6,17823,227,68,-3324,-1398,22.7,1438.5
4517973417,1,15,5,1,7,1,10,1,1,0,0,16932,7.2,19942,235,55,2699,2575,23.5,1693.2,53,5,0,1,7,1,0,0,0,0,14233,6.8,17367,242,52,-2699,-2575,24.2,1423.3
4524202231,1,14,2,1,9,4,6,1,1,0,0,18532,7.4,20134,231,55,3195,1370,23.1,1853.2,124,2,0,4,9,1,0,0,0,0,15337,7.2,18764,223,64,-3195,-1370,22.3,1533.7
4491334204,1,19,7,1,13,5,14,0,0,0,0,19610,7.6,20901,220,51,4491,5575,22.0,1961.0,17,1,0,5,13,4,1,1,0,0,15119,6.2,15326,186,51,-4491,-5575,18.6,1511.9
4526116329,1,15,1,1,8,6,5,0,0,0,0,17693,7.0,18557,251,40,2501,2231,25.1,1769.3,15,1,0,6,8,7,0,0,0,0,15192,6.4,16326,176,52,-2501,-2231,17.6,1519.2
4486554038,1,52,1,1,4,2,2,2,1,1,0,15897,7.0,19077,235,68,188,1159,23.5,1589.7,14,2,0,2,4,3,0,0,0,0,15709,6.6,17918,255,53,-188,-1159,25.5,1570.9
4511697354,1,16,3,1,11,6,17,0,0,0,0,17895,6.8,16640,191,38,2088,-118,19.1,1789.5,16,3,0,6,11,5,1,1,0,0,15807,6.6,16758,202,41,-2088,118,20.2,1580.7
4499844894,1,40,1,0,6,8,10,1,0,1,0,18012,7.2,19837,250,70,832,1330,25.0,1801.2,12,1,1,8,6,11,1,1,0,0,17180,7.0,18507,186,48,-832,-1330,18.6,1718.0
4516572931,1,13,1,1,9,3,9,2,1,1,0,19027,7.2,19029,247,41,4616,2050,24.7,1902.7,12,2,0,3,9,1,0,0,0,0,14411,6.6,16979,187,54,-4616,-2050,18.7,1441.1
4442489042,1,11,1,1,5,1,5,0,0,0,0,17467,7.4,20584,245,76,3407,3210,24.5,1746.7,85,0,0,1,5,3,0,0,0,0,14060,6.8,17374,214,59,-3407,-3210,21.4,1406.0
4526207203,1,24,4,1,8,5,6,0,0,0,0,17581,7.0,18639,243,45,1839,312,24.3,1758.1,122,1,0,5,8,2,1,1,0,0,15742,7.2,18327,221,45,-1839,-312,22.1,1574.2
4519425704,1,15,7,1,11,5,12,0,0,0,0,18480,6.8,17912,201,42,2532,1229,20.1,1848.0,14,3,0,5,11,10,0,0,0,0,15948,6.6,16683,203,51,-2532,-1229,20.3,1594.8
4477701411,1,17,5,0,6,10,7,1,0,1,0,16100,7.0,17451,192,60,-2907,-1376,19.2,1610.0,18,3,1,10,6,9,1,1,0,0,19007,7.2,18827,260,40,2907,1376,26.0,1900.7
4426718140,1,24,3,1,5,8,7,1,0,1,0,16137,6.6,17271,219,51,-80,-155,21.9,1613.7,16,6,0,8,5,9,1,1,0,0,16217,7.0,17426,205,40,80,155,20.5,1621.7
4469425272,1,34,1,1,3,2,6,1,1,0,0,16426,7.0,18180,236,64,2063,708,23.6,1642.6,14,2,0,2,3,6,0,0,0,0,14363,6.6,17472,210,40,-2063,-708,21.0,1436.3
4513598574,1,14,1,1,8,6,7,0,0,0,0,18634,7.0,19500,239,56,2077,1804,23.9,1863.4,17,3,0,6,8,12,1,1,0,0,16557,6.8,17696,196,71,-2077,-1804,19.6,1655.7
4498636614,1,15,2,1,7,4,7,2,1,1,0,18227,7.2,19568,256,61,2689,2827,25.6,1822.7,15,1,0,4,7,4,0,0,0,0,15538,6.6,16741,224,36,-2689,-2827,22.4,1553.8
4489642674,1,38,4,1,6,5,6,1,1,0,0,16098,6.8,18103,209,50,-282,-192,20.9,1609.8,16,4,0,5,6,5,1,0,1,0,16380,7.0,18295,224,62,282,192,22.4,1638.0
4505154902,1,44,1,1,10,2,13,1,1,0,0,17519,6.8,17753,209,37,4216,2141,20.9,1751.9,11,2,0,2,10,1,0,0,0,0,13303,6.4,15612,197,38,-4216,-2141,19.7,1330.3
4510949309,1,47,1,1,8,3,8,2,1,1,1,18237,7.0,18102,230,48,3675,2389,23.0,1823.7,12,0,0,3,8,4,0,0,0,0,14562,6.0,15713,170,62,-3675,-2389,17.0,1456.2
4500361216,1,18,2,1,3,3,8,0,0,0,0,15667,7.0,17801,212,64,644,427,21.2,1566.7,62,3,0,3,3,5,1,1,0,0,15023,7.0,17374,194,64,-644,-427,19.4,1502.3
4490273842,1,17,3,1,6,4,5,2,1,1,0,16727,7.2,18834,220,55,613,-602,22.0,1672.7,40,3,0,4,6,3,0,0,0,0,16114,7.4,19436,247,52,-613,602,24.7,1611.4
4486155288,1,83,6,0,6,4,7,2,1,1,0,16699,7.0,18503,242,55,1109,718,24.2,1669.9,19,5,1,4,6,6,0,0,0,0,15590,6.8,17785,237,41,-1109,-718,23.7,1559.0
4524603410,1,15,1,1,8,7,6,1,1,0,0,17850,7.2,19943,238,71,1097,1914,23.8,1785.0,16,2,0,7,8,6,0,0,0,0,16753,7.0,18029,224,40,-1097,-1914,22.4,1675.3
4491875550,1,38,1,1,7,5,4,1,1,0,0,16605,7.0,18407,199,61,-643,508,19.9,1660.5,17,3,0,5,7,5,1,0,1,1,17248,6.8,17899,241,46,643,-508,24.1,1724.8
4490133266,1,16,1,0,8,5,8,1,1,0,0,17405,7.2,19297,229,46,1198,197,22.9,1740.5,36,3,1,5,8,1,0,0,0,0,16207,7.2,19100,237,64,-1198,-197,23.7,1620.7
4527078331,1,8,1,1,8,4,7,1,1,0,0,18257,7.0,19371,246,60,3149,1513,24.6,1825.7,15,1,0,4,8,1,0,0,0,0,15108,6.8,17858,227,61,-3149,-1513,22.7,1510.8
4526865025,1,16,5,0,8,5,7,1,1,0,0,16770,7.4,19515,212,52,402,1641,21.2,1677.0,18,5,1,5,8,6,0,0,0,0,16368,6.8,17874,222,52,-402,-1641,22.2,1636.8
4521167934,1,16,2,1,6,3,3,0,0,0,0,16454,7.0,18902,228,63,1510,1545,22.8,1645.4,13,0,0,3,6,2,1,1,0,0,14944,7.0,17357,222,60,-1510,-1545,22.2,1494.4
4494766750,1,68,2,1,9,3,16,0,0,0,0,17718,7.0,18091,209,48,3017,1450,20.9,1771.8,17,2,0,3,9,2,0,0,0,0,14701,6.8,16641,197,52,-3017,-1450,19.7,1470.1
4494040158,1,16,1,1,6,8,10,1,1,0,0,15388,6.4,15544,153,60,-3077,-3160,15.3,1538.8,14,1,0,8,6,5,1,0,1,1,18465,7.0,18704,214,59,3077,3160,21.4,1846.5
4507115446,1,14,8,0,6,4,11,1,1,0,0,16538,7.2,18707,235,55,1585,1348,23.5,1653.8,14,3,1,4,6,4,0,0,0,0,14953,6.6,17359,189,44,-1585,-1348,18.9,1495.3
4513553506,1,39,1,1,8,11,8,0,0,0,0,17072,6.8,17724,180,63,-2298,-730,18.0,1707.2,13,2,0,11,8,5,2,1,1,1,19370,7.0,18454,242,48,2298,730,24.2,1937.0
4503781874,1,11,2,1,4,4,8,1,1,0,0,16341,7.4,19567,236,72,1567,1637,23.6,1634.1,14,0,0,4,4,3,1,0,1,0,14774,6.8,17930,203,55,-1567,-1637,20.3,1477.4
4505187643,1,66,2,1,10,3,11,1,0,1,0,17992,7.0,18842,212,51,3313,1465,21.2,1799.2,13,0,0,3,10,4,1,1,0,0,14679,6.8,17377,217,52,-3313,-1465,21.7,1467.9
4495034675,1,17,5,1,8,3,4,0,0,0,0,17058,6.8,16737,207,40,2559,806,20.7,1705.8,17,2,0,3,8,4,0,0,0,0,14499,6.4,15931,196,51,-2559,-806,19.6,1449.9
4512324600,1,15,2,0,9,4,12,1,1,0,0,17233,6.8,17651,202,48,2034,884,20.2,1723.3,14,1,1,4,9,4,0,0,0,0,15199,6.6,16767,200,48,-2034,-884,20.0,1519.9
4511791303,1,15,1,1,5,3,2,1,1,0,0,16421,7.0,18152,241,48,1239,-1051,24.1,1642.1,42,1,0,3,5,2,0,0,0,0,15182,7.2,19203,219,73,-1239,1051,21.9,1518.2
4523536218,1,38,0,1,6,3,7,0,0,0,0,16887,7.4,19954,232,64,846,680,23.2,1688.7,14,21,0,3,6,1,1,1,0,0,16041,7.2,19274,242,64,-846,-680,24.2,1604.1
4520495410,1,14,7,0,6,6,9,1,1,0,1,18409,6.8,18255,212,60,225,-216,21.2,1840.9,24,3,1,6,6,4,1,0,1,2,18184,7.0,18471,242,60,-225,216,24.2,1818.4
4511912141,1,12,3,1,8,4,9,1,1,0,0,17779,6.8,18276,247,53,2988,398,24.7,1777.9,14,1,0,4,8,1,0,0,0,0,14791,7.0,17878,210,47,-2988,-398,21.0,1479.1
4457833778,1,17,1,1,5,6,5,0,0,0,0,16781,6.8,18303,222,48,679,1400,22.2,1678.1,17,0,0,6,5,6,1,1,0,0,16102,6.6,16903,192,57,-679,-1400,19.2,1610.2
4509854738,1,16,1,1,7,4,8,1,1,0,0,16351,6.8,17063,171,55,1487,1143,17.1,1635.1,15,0,0,4,7,2,0,0,0,0,14864,6.4,15920,224,28,-1487,-1143,22.4,1486.4
4525362922,1,15,3,0,3,5,2,1,1,0,0,14986,6.8,17946,220,72,-2042,-436,22.0,1498.6,15,2,1,5,3,6,1,0,1,1,17028,7.0,18382,232,24,2042,436,23.2,1702.8
4526265417,1,12,2,1,7,2,10,1,1,0,0,18234,7.4,19881,243,64,4651,4293,24.3,1823.4,9,1,0,2,7,2,0,0,0,0,13583,6.2,15588,156,52,-4651,-4293,15.6,1358.3
4503948096,1,15,2,1,7,3,4,1,1,0,0,16656,6.8,17435,214,67,1786,-261,21.4,1665.6,15,1,0,3,7,3,0,0,0,0,14870,6.8,17696,206,49,-1786,261,20.6,1487.0
4502088283,1,44,4,0,5,5,5,0,0,0,0,15810,7.2,18914,208,56,-866,388,20.8,1581.0,16,15,1,5,5,3,1,1,0,0,16676,6.8,18526,253,51,866,-388,25.3,1667.6
4480246258,1,15,1,0,2,8,1,1,0,1,0,15041,6.8,17616,229,58,-3259,-1311,22.9,1504.1,19,3,1,8,2,13,1,1,0,0,18300,7.0,18927,249,56,3259,1311,24.9,1830.0
4441973762,1,15,3,1,13,9,13,1,1,0,1,21908,7.4,20909,227,84,4612,2877,22.7,2190.8,15,1,0,9,13,12,0,0,0,0,17296,7.0,18032,195,44,-4612,-2877,19.5,1729.6
4445985804,1,19,4,1,7,2,8,1,1,0,0,17459,7.2,19021,231,64,2929,1296,23.1,1745.9,15,1,0,2,7,2,0,0,0,0,14530,7.0,17725,191,64,-2929,-1296,19.1,1453.0
4487414658,1,15,2,1,4,2,3,1,1,0,0,16521,7.2,18785,261,48,2101,1400,26.1,1652.1,19,3,0,2,4,2,0,0,0,0,14420,6.6,17385,215,56,-2101,-1400,21.5,1442.0
4511166126,1,35,2,0,4,7,6,0,0,0,0,15074,6.8,17596,214,52,-2054,-731,21.4,1507.4,16,0,1,7,4,10,2,1,1,0,17128,7.0,18327,211,50,2054,731,21.1,1712.8
4511153388,1,13,2,0,4,2,2,0,0,0,0,17005,7.2,19366,268,60,1973,1236,26.8,1700.5,15,3,1,2,4,0,1,1,0,0,15032,6.8,18130,241,72,-1973,-1236,24.1,1503.2
4500291945,1,16,0,1,7,3,10,1,1,0,0,17546,6.8,17209,228,47,1493,1167,22.8,1754.6,10,2,0,3,7,4,1,0,1,1,16053,6.4,16042,193,51,-1493,-1167,19.3,1605.3
4524793745,1,16,2,0,11,10,17,1,1,0,0,18858,7.4,19797,214,62,878,2182,21.4,1885.8,15,2,1,10,11,11,0,0,0,0,17980,6.8,17615,204,28,-878,-2182,20.4,1798.0
4525209452,1,17,1,0,3,7,1,1,1,0,0,14970,6.6,16402,208,54,-1187,-1058,20.8,1497.0,16,3,1,7,3,6,0,0,0,0,16157,6.8,17460,208,55,1187,1058,20.8,1615.7
4525011437,1,17,3,0,9,11,12,0,0,0,0,16899,6.8,16675,180,39,-1507,-1389,18.0,1689.9,14,3,1,11,9,14,2,1,1,0,18406,7.0,18064,217,48,1507,1389,21.7,1840.6
4490211432,1,18,4,0,6,10,9,0,0,0,0,15445,6.4,16320,188,40,-3473,-1314,18.8,1544.5,15,2,1,10,6,11,0,0,0,0,18918,6.8,17634,217,40,3473,1314,21.7,1891.8
4526469771,1,45,4,1,14,5,22,0,0,0,0,19551,7.2,18331,198,43,2896,2001,19.8,1955.1,13,5,0,5,14,6,0,0,0,0,16655,6.6,16330,228,35,-2896,-2001,22.8,1665.5
4519687023,1,18,1,0,2,6,2,0,0,0,0,14071,6.8,16114,231,47,-2633,-1640,23.1,1407.1,13,4,1,6,2,6,1,1,0,0,16704,6.8,17754,238,52,2633,1640,23.8,1670.4
4520878997,1,38,4,0,0,4,0,0,0,0,0,14144,6.6,16975,228,60,-1473,-29,22.8,1414.4,18,3,1,4,0,6,1,1,0,0,15617,6.6,17004,228,49,1473,29,22.8,1561.7
4500522425,1,18,4,0,7,2,7,1,1,0,0,17103,7.0,19263,221,56,2481,2112,22.1,1710.3,18,4,1,2,7,2,0,0,0,0,14622,7.0,17151,210,52,-2481,-2112,21.0,1462.2
4467720133,1,15,8,1,10,4,10,2,1,1,0,18818,7.4,19037,215,60,4107,1820,21.5,1881.8,18,3,0,4,10,2,0,0,0,0,14711,6.8,17217,209,49,-4107,-1820,20.9,1471.1
4505357300,1,16,4,0,6,6,5,0,0,0,0,16029,7.0,18567,205,56,-355,233,20.5,1602.9,19,3,1,6,6,5,1,1,0,0,16384,7.0,18334,224,48,355,-233,22.4,1638.4
4450495621,1,16,1,1,9,5,12,0,0,0,0,16759,7.0,17756,183,48,988,581,18.3,1675.9,13,5,0,5,9,9,2,1,1,0,15771,6.6,17175,198,59,-988,-581,19.8,1577.1
4480457394,1,17,0,0,5,5,4,1,1,0,0,16525,7.0,18498,230,57,1262,413,23.0,1652.5,17,2,1,5,5,3,0,0,0,0,15263,7.0,18085,212,54,-1262,-413,21.2,1526.3
4508349018,1,15,1,0,8,10,10,1,0,1,0,16688,6.8,17007,201,51,-1198,-768,20.1,1668.8,18,4,1,10,8,14,1,1,0,0,17886,7.2,17775,209,49,1198,768,20.9,1788.6
4521293545,1,17,1,1,6,2,5,1,0,1,0,17834,7.2,19145,276,44,3797,2242,27.6,1783.4,10,1,0,2,6,3,1,1,0,0,14037,6.8,16903,202,48,-3797,-2242,20.2,1403.7
4507851254,1,52,2,0,6,5,12,0,0,0,1,17107,6.8,17665,215,43,-1661,-1259,21.5,1710.7,19,3,1,5,6,4,2,1,1,2,18768,7.0,18924,239,71,1661,1259,23.9,1876.8
4460077928,1,17,4,1,9,8,12,0,0,0,0,18385,7.4,19948,248,65,607,1293,24.8,1838.5,17,5,0,8,9,8,2,1,1,0,17778,7.0,18655,240,56,-607,-1293,24.0,1777.8
4496579153,1,16,2,1,8,2,7,1,0,1,0,17755,7.2,19720,228,48,3755,2662,22.8,1775.5,14,1,0,2,8,3,0,0,0,0,14000,6.6,17058,183,51,-3755,-2662,18.3,1400.0
4514754903,1,16,2,1,7,2,10,2,1,1,1,18890,7.2,18772,227,67,4234,1695,22.7,1889.0,58,0,0,2,7,3,0,0,0,0,14656,6.6,17077,214,48,-4234,-1695,21.4,1465.6
4520913464,1,15,1,0,6,3,10,2,1,1,0,17377,7.2,19245,247,68,2101,1596,24.7,1737.7,75,2,1,3,6,5,0,0,0,0,15276,6.8,17649,193,59,-2101,-1596,19.3,1527.6
4515347067,1,59,1,1,5,2,3,1,0,1,0,16014,7.0,18969,225,58,476,467,22.5,1601.4,21,6,0,2,5,1,0,0,0,0,15538,7.2,18502,257,53,-476,-467,25.7,1553.8
4521238149,1,18,6,0,3,2,1,0,0,0,0,15681,7.0,19274,231,52,919,1527,23.1,1568.1,53,7,1,2,3,2,1,1,0,0,14762,7.0,17747,230,58,-919,-1527,23.0,1476.2
4508612227,1,16,3,1,9,2,8,2,1,1,0,17303,7.0,18705,219,49,2871,2154,21.9,1730.3,16,2,0,2,9,3,0,0,0,0,14432,6.8,16551,217,52,-2871,-2154,21.7,1443.2
4518071306,1,18,3,1,15,8,12,1,1,0,0,20855,7.2,20164,196,46,4083,3740,19.6,2085.5,17,3,0,8,15,8,0,0,0,0,16772,6.6,16424,171,44,-4083,-3740,17.1,1677.2
4499246696,1,10,2,1,8,5,8,0,0,0,0,17615,7.0,18307,206,46,3686,1471,20.6,1761.5,17,0,0,5,8,4,0,0,0,0,13929,6.6,16836,153,46,-3686,-1471,15.3,1392.9
4523326284,1,21,2,1,8,6,9,2,1,1,0,17808,7.0,18545,246,44,2489,1473,24.6,1780.8,17,3,0,6,8,4,0,0,0,0,15319,6.6,17072,191,42,-2489,-1473,19.1,1531.9
4521648781,1,20,3,1,10,6,11,0,0,0,0,19000,7.2,18915,233,39,1259,-60,23.3,1900.0,17,5,0,6,10,7,0,0,0,0,17741,7.0,18975,264,44,-1259,60,26.4,1774.1
4463150629,1,20,5,1,10,7,16,1,1,0,0,18247,7.0,18886,225,36,1348,1158,22.5,1824.7,38,5,0,7,10,10,1,0,1,0,16899,6.6,17728,224,68,-1348,-1158,22.4,1689.9
4519912865,1,13,3,0,12,4,11,0,0,0,0,19331,7.2,19387,255,50,4003,2566,25.5,1933.1,17,1,1,4,12,5,1,1,0,0,15328,6.8,16821,215,50,-4003,-2566,21.5,1532.8
4525174684,1,16,2,1,5,2,5,1,1,0,0,16594,7.4,20008,227,76,1737,1565,22.7,1659.4,13,0,0,2,5,3,0,0,0,0,14857,7.0,18443,217,72,-1737,-1565,21.7,1485.7
4524945992,1,11,2,1,11,10,8,1,1,0,0,18104,6.8,17404,205,40,1117,-637,20.5,1810.4,17,0,0,10,11,6,0,0,0,0,16987,6.8,18041,168,41,-1117,637,16.8,1698.7
4524250490,1,16,3,0,6,4,1,0,0,0,0,16327,7.0,18521,190,59,1570,1320,19.0,1632.7,16,1,1,4,6,1,1,1,0,0,14757,6.8,17201,214,56,-1570,-1320,21.4,1475.7
4453299408,1,41,3,1,8,10,10,1,1,0,0,16526,7.0,18130,174,44,-2720,-2680,17.4,1652.6,19,5,0,10,8,7,0,0,0,0,19246,7.6,20810,239,79,2720,2680,23.9,1924.6
4525134229,1,19,2,1,7,1,11,1,1,0,0,17566,7.2,19634,243,56,2821,2755,24.3,1756.6,14,2,0,1,7,3,0,0,0,0,14745,6.8,16879,234,54,-2821,-2755,23.4,1474.5
4486111513,1,16,4,0,5,7,6,0,0,0,0,16402,7.0,17710,223,68,194,-220,22.3,1640.2,14,5,1,7,5,8,0,0,0,0,16208,7.0,17930,195,56,-194,220,19.5,1620.8
4520625365,1,39,1,0,7,5,9,1,1,0,0,16460,7.0,17849,220,48,23,-338,22.0,1646.0,16,1,1,5,7,8,0,0,0,0,16437,7.0,18187,222,48,-23,338,22.2,1643.7
4500388564,1,16,4,1,5,8,5,1,0,1,0,16607,7.0,17949,223,68,-1001,-543,22.3,1660.7,54,2,0,8,5,10,1,1,0,0,17608,7.0,18492,229,41,1001,543,22.9,1760.8
4519160523,1,41,4,1,8,9,10,1,1,0,0,16076,6.2,14942,181,42,143,-603,18.1,1607.6,12,0,0,9,8,18,0,0,0,0,15933,6.4,15545,178,32,-143,603,17.8,1593.3
4483729967,1,13,1,1,3,4,6,0,0,0,0,15223,6.8,17157,217,56,-299,-238,21.7,1522.3,25,3,0,4,3,7,1,1,0,0,15522,6.8,17395,203,72,299,238,20.3,1552.2
4467109109,1,15,4,1,5,12,3,0,0,0,0,16358,6.8,17640,206,56,-2651,-1695,20.6,1635.8,16,5,0,12,5,14,0,0,0,0,19009,7.2,19335,218,64,2651,1695,21.8,1900.9
4516590665,1,10,0,0,5,12,4,1,1,0,0,15708,7.0,17799,219,59,-3205,-2487,21.9,1570.8,15,3,1,12,5,8,1,0,1,1,18913,7.4,20286,231,47,3205,2487,23.1,1891.3
4521408413,1,15,1,1,10,8,14,2,1,1,0,18360,7.2,19276,222,44,793,475,22.2,1836.0,14,0,0,8,10,7,0,0,0,0,17567,7.4,18801,215,56,-793,-475,21.5,1756.7
4524343815,1,16,3,0,2,7,4,1,0,1,0,14010,6.4,16322,187,38,-3047,-612,18.7,1401.0,13,3,1,7,2,9,1,1,0,0,17057,6.6,16934,215,38,3047,612,21.5,1705.7
4527033024,1,13,0,0,11,2,15,1,1,0,0,19508,7.4,19814,233,60,4882,2658,23.3,1950.8,13,1,1,2,11,1,0,0,0,0,14626,6.8,17156,219,60,-4882,-2658,21.9,1462.6
4499273242,1,36,3,1,17,7,24,1,0,1,0,20182,7.6,20589,199,44,3404,2667,19.9,2018.2,13,1,0,7,17,5,1,1,0,0,16778,7.0,17922,206,61,-3404,-2667,20.6,1677.8
4451359541,1,14,0,1,8,4,10,1,1,0,0,16912,7.0,17678,222,38,1416,-211,22.2,1691.2,14,1,0,4,8,3,0,0,0,0,15496,6.8,17889,196,60,-1416,211,19.6,1549.6
4412978193,1,15,0,1,10,7,11,2,1,1,0,16743,6.6,17531,189,44,52,221,18.9,1674.3,14,2,0,7,10,5,0,0,0,0,16691,6.8,17310,208,38,-52,-221,20.8,1669.1
4467276496,1,36,1,1,5,5,8,0,0,0,0,16192,6.8,18197,209,60,1056,-182,20.9,1619.2,11,1,0,5,5,4,1,1,0,0,15136,7.0,18379,185,46,-1056,182,18.5,1513.6
4500392073,1,90,7,0,7,4,5,1,1,0,0,17929,7.4,20365,233,59,3140,3364,23.3,1792.9,16,5,1,4,7,4,1,0,1,0,14789,6.6,17001,201,52,-3140,-3364,20.1,1478.9
4494953056,1,17,4,1,6,2,5,2,1,1,1,17945,7.0,18758,268,44,2404,1129,26.8,1794.5,94,5,0,2,6,1,0,0,0,0,15541,6.8,17629,260,49,-2404,-1129,26.0,1554.1
4516015369,1,11,4,1,13,6,8,0,0,0,0,19537,7.4,19905,242,46,3608,2893,24.2,1953.7,16,2,0,6,13,10,1,1,0,0,15929,6.6,17012,188,53,-3608,-2893,18.8,1592.9
4489878526,1,14,2,1,6,4,6,0,0,0,0,16493,7.2,18450,231,46,628,-243,23.1,1649.3,17,3,0,4,6,6,1,1,0,0,15865,7.0,18693,212,67,-628,243,21.2,1586.5
4476131958,1,41,0,0,6,3,5,0,0,0,0,16495,7.2,18530,232,59,1037,922,23.2,1649.5,33,2,1,3,6,2,0,0,0,0,15458,6.6,17608,238,48,-1037,-922,23.8,1545.8
4490153462,1,12,0,0,5,6,8,1,1,0,0,16891,6.8,18030,185,48,286,17,18.5,1689.1,44,4,1,6,5,12,0,0,0,0,16605,6.8,18013,214,47,-286,-17,21.4,1660.5
4523041821,1,17,4,0,5,5,3,2,1,1,0,16344,7.2,19071,227,64,1168,2292,22.7,1634.4,17,2,1,5,5,3,0,0,0,0,15176,6.8,16779,206,38,-1168,-2292,20.6,1517.6
4516616203,1,23,0,0,2,5,1,0,0,0,0,15508,7.0,17985,258,60,-919,-923,25.8,1550.8,11,2,1,5,2,8,0,0,0,0,16427,7.2,18908,226,48,919,923,22.6,1642.7
4519919253,1,16,0,0,5,7,4,1,0,1,0,15994,6.8,17724,225,52,-144,1497,22.5,1599.4,14,5,1,7,5,12,0,0,0,0,16138,6.4,16227,183,44,144,-1497,18.3,1613.8
4515886739,1,12,4,0,8,4,15,0,0,0,0,16894,7.2,18333,219,40,1077,1096,21.9,1689.4,16,1,1,4,8,4,0,0,0,0,15817,6.8,17237,208,63,-1077,-1096,20.8,1581.7
4521233015,1,16,2,1,14,6,11,1,1,0,0,18537,7.2,19024,200,48,1809,1633,20.0,1853.7,15,1,0,6,14,5,0,0,0,0,16728,6.8,17391,193,64,-1809,-1633,19.3,1672.8
4519327182,1,14,2,0,9,8,13,0,0,0,0,18808,7.2,19323,244,40,948,292,24.4,1880.8,15,3,1,8,9,10,1,1,0,0,17860,7.0,19031,234,71,-948,-292,23.4,1786.0
4516563869,1,14,4,1,8,6,10,1,1,0,0,17776,6.8,18126,224,45,1072,411,22.4,1777.6,17,2,0,6,8,8,0,0,0,0,16704,6.6,17715,238,51,-1072,-411,23.8,1670.4
4433590023,1,17,6,1,13,0,14,1,1,0,1,20095,7.6,20229,219,48,6770,4384,21.9,2009.5,14,3,0,0,13,0,0,0,0,0,13325,6.6,15845,199,56,-6770,-4384,19.9,1332.5
4468732592,1,16,5,1,7,4,10,0,0,0,0,18342,7.4,20325,224,75,2587,2759,22.4,1834.2,164,2,0,4,7,3,1,1,0,0,15755,6.6,17566,213,54,-2587,-2759,21.3,1575.5
4526284156,1,19,1,0,7,9,8,0,0,0,0,16481,7.0,17470,223,44,-246,-1064,22.3,1648.1,11,1,1,9,7,6,0,0,0,0,16727,7.0,18534,220,31,246,1064,22.0,1672.7
4526583162,1,16,4,1,9,3,13,1,1,0,0,19186,7.2,19737,261,52,4331,3427,26.1,1918.6,14,2,0,3,9,4,0,0,0,0,14855,6.4,16310,199,48,-4331,-3427,19.9,1485.5
4491158196,1,18,3,1,10,7,12,1,0,1,1,19262,7.0,18021,223,44,1497,1555,22.3,1926.2,13,7,0,7,10,7,1,1,0,1,17765,6.6,16466,211,45,-1497,-1555,21.1,1776.5
4527696871,1,36,2,1,9,4,11,1,1,0,0,18503,7.4,19717,250,56,2527,1695,25.0,1850.3,26,16,0,4,9,9,0,0,0,0,15976,7.0,18022,210,63,-2527,-1695,21.0,1597.6
4517750444,1,18,3,1,7,5,8,1,1,0,0,17561,6.6,17813,215,64,545,411,21.5,1756.1,16,1,0,5,7,1,1,0,1,1,17016,6.6,17402,218,44,-545,-411,21.8,1701.6
4491198019,1,17,4,1,2,4,0,0,0,0,0,15321,7.0,18162,255,55,305,992,25.5,1532.1,56,2,0,4,2,5,1,1,0,0,15016,6.8,17170,222,40,-305,-992,22.2,1501.6
4509867417,1,37,3,1,8,4,14,1,1,0,0,18664,7.4,20054,233,63,3326,3001,23.3,1866.4,16,2,0,4,8,2,0,0,0,0,15338,6.6,17053,215,56,-3326,-3001,21.5,1533.8
4472618887,1,17,3,1,9,6,8,1,1,0,0,17410,7.0,18627,190,60,1578,495,19.0,1741.0,15,2,0,6,9,6,0,0,0,0,15832,7.0,18132,195,52,-1578,-495,19.5,1583.2
4521070500,1,16,4,0,4,3,4,0,0,0,0,15616,6.8,18728,224,40,441,379,22.4,1561.6,15,2,1,3,4,2,0,0,0,0,15175,6.8,18349,230,48,-441,-379,23.0,1517.5
4525939080,1,15,3,0,10,7,12,0,0,0,0,17892,7.0,18432,197,52,1017,547,19.7,1789.2,15,2,1,7,10,7,1,1,0,0,16875,7.0,17885,201,48,-1017,-547,20.1,1687.5
4524555645,1,14,1,0,10,8,10,1,0,1,0,17793,7.0,18327,193,55,496,187,19.3,1779.3,14,0,1,8,10,7,1,1,0,0,17297,6.8,18140,220,44,-496,-187,22.0,1729.7
4526930343,1,13,1,1,6,6,6,1,1,0,0,16019,6.6,17728,193,47,-612,-167,19.3,1601.9,16,1,0,6,6,8,0,0,0,0,16631,7.0,17895,218,51,612,167,21.8,1663.1
4470635951,1,15,3,1,9,5,15,0,0,0,0,18721,7.2,19444,240,48,2411,1852,24.0,1872.1,14,4,0,5,9,6,1,1,0,0,16310,6.8,17592,219,58,-2411,-1852,21.9,1631.0
4521258257,1,18,6,1,4,4,3,0,0,0,0,15936,6.8,16572,229,44,218,-1933,22.9,1593.6,42,5,0,4,4,5,1,1,0,0,15718,7.0,18505,243,52,-218,1933,24.3,1571.8
4517535335,1,27,9,0,6,5,6,1,1,0,0,16893,7.0,18950,238,64,568,1096,23.8,1689.3,43,8,1,5,6,6,0,0,0,0,16325,7.0,17854,231,48,-568,-1096,23.1,1632.5
4521046337,1,16,3,1,8,3,8,0,0,0,0,17849,7.0,18536,227,40,3364,2412,22.7,1784.9,15,1,0,3,8,2,1,1,0,0,14485,6.4,16124,223,49,-3364,-2412,22.3,1448.5
4526364415,1,14,4,1,5,6,4,1,1,0,0,15063,6.6,16316,198,43,-1547,-1049,19.8,1506.3,19,1,0,6,5,3,0,0,0,0,16610,6.8,17365,229,40,1547,1049,22.9,1661.0
4524990107,1,14,4,1,8,6,8,2,1,1,1,18250,7.0,17742,235,37,2518,860,23.5,1825.0,16,0,0,6,8,6,0,0,0,0,15732,6.6,16882,216,40,-2518,-860,21.6,1573.2
4514235759,1,15,0,0,9,8,5,1,0,1,0,17149,6.8,17767,211,35,-417,-1028,21.1,1714.9,39,4,1,8,9,6,1,1,0,0,17566,7.0,18795,215,61,417,1028,21.5,1756.6
4524775955,1,14,2,0,6,9,7,2,1,1,0,15649,6.8,17052,186,44,-2822,-1240,18.6,1564.9,13,2,1,9,6,9,0,0,0,0,18471,7.0,18292,248,32,2822,1240,24.8,1847.1
4526731314,1,18,3,1,5,6,6,1,0,1,0,15743,6.6,16662,212,48,-720,-1533,21.2,1574.3,21,5,0,6,5,11,1,1,0,0,16463,7.0,18195,229,48,720,1533,22.9,1646.3
4527293021,1,10,7,1,5,3,5,1,1,0,0,15239,7.2,18919,218,45,742,2904,21.8,1523.9,22,2,0,3,5,4,0,0,0,0,14497,6.6,16015,182,58,-742,-2904,18.2,1449.7
4497704754,1,19,2,1,3,4,3,0,0,0,0,15268,6.2,15740,202,60,460,-952,20.2,1526.8,14,5,0,4,3,9,1,1,0,0,14808,6.6,16692,209,40,-460,952,20.9,1480.8
4450562955,1,22,3,1,7,0,8,1,1,0,0,18285,7.4,20035,259,52,4649,3488,25.9,1828.5,37,0,0,0,7,0,0,0,0,0,13636,6.4,16547,215,56,-4649,-3488,21.5,1363.6
4525766056,1,23,2,1,6,3,7,1,1,0,0,16600,7.2,18185,238,53,1825,996,23.8,1660.0,17,3,0,3,6,4,0,0,0,0,14775,6.8,17189,228,39,-1825,-996,22.8,1477.5
4517776491,1,17,4,1,5,3,5,0,0,0,0,17322,7.0,19067,229,63,3005,1938,22.9,1732.2,18,2,0,3,5,4,0,0,0,0,14317,6.4,17129,197,32,-3005,-1938,19.7,1431.7
4524963082,1,13,3,0,2,7,2,0,0,0,0,13825,6.6,15977,185,51,-2891,-3196,18.5,1382.5,16,0,1,7,2,7,0,0,0,0,16716,7.4,19173,229,53,2891,3196,22.9,1671.6
4504510674,1,16,4,1,5,6,6,0,0,0,0,16632,6.8,17833,215,59,999,482,21.5,1663.2,15,5,0,6,5,10,1,1,0,0,15633,7.0,17351,198,49,-999,-482,19.8,1563.3
4513468208,1,15,4,0,5,11,6,0,0,0,0,14813,6.8,16945,182,43,-3707,-1742,18.2,1481.3,19,3,1,11,5,10,2,1,1,0,18520,7.2,18687,225,60,3707,1742,22.5,1852.0
4499657757,1,16,1,1,7,6,8,0,0,0,0,17812,7.0,18372,244,56,1745,1180,24.4,1781.2,14,3,0,6,7,10,1,1,0,0,16067,6.8,17192,216,60,-1745,-1180,21.6,1606.7
4526637754,1,15,0,1,9,11,14,0,0,0,0,18306,6.8,17828,207,56,737,50,20.7,1830.6,41,1,0,11,9,12,1,1,0,0,17569,7.0,17778,183,43,-737,-50,18.3,1756.9
4512338231,1,13,4,1,7,5,5,1,1,0,0,16790,7.6,19460,241,62,651,1744,24.1,1679.0,13,3,0,5,7,10,0,0,0,0,16139,6.8,17716,186,65,-651,-1744,18.6,1613.9
4521299727,1,35,3,1,13,5,16,0,0,0,0,19452,7.6,20776,212,59,2593,3690,21.2,1945.2,14,3,0,5,13,7,2,1,1,0,16859,6.8,17086,213,64,-2593,-3690,21.3,1685.9
4523349823,1,9,5,0,6,6,6,1,0,1,0,16421,7.4,19037,224,50,961,849,22.4,1642.1,18,0,1,6,6,4,0,0,0,0,15460,7.0,18188,194,48,-961,-849,19.4,1546.0
4524838137,1,16,0,0,10,8,9,0,0,0,0,18033,7.2,18634,201,52,1324,1692,20.1,1803.3,13,3,1,8,10,8,1,0,1,0,16709,6.8,16942,185,56,-1324,-1692,18.5,1670.9
4518622747,1,16,2,1,12,10,10,2,1,1,1,20065,7.2,18844,204,71,2763,3068,20.4,2006.5,16,3,0,10,12,11,0,0,0,0,17302,6.4,15776,168,39,-2763,-3068,16.8,1730.2
4515360934,1,14,7,1,8,6,12,1,1,0,0,17357,7.0,18244,222,48,1031,829,22.2,1735.7,16,2,0,6,8,10,1,0,1,0,16326,6.8,17415,208,36,-1031,-829,20.8,1632.6
4511726716,1,84,3,0,8,6,8,0,0,0,0,16602,6.8,16879,163,49,-786,-808,16.3,1660.2,46,0,1,6,8,2,0,0,0,1,17388,6.8,17687,206,54,786,808,20.6,1738.8
4521259209,1,13,2,0,5,6,4,1,1,0,0,15596,7.0,17998,198,44,-305,-474,19.8,1559.6,25,2,1,6,5,7,0,0,0,0,15901,7.0,18472,199,40,305,474,19.9,1590.1
4485983759,1,39,2,1,11,8,16,0,0,0,0,17860,6.8,17606,172,48,1240,-349,17.2,1786.0,14,2,0,8,11,6,1,0,1,0,16620,6.8,17955,202,51,-1240,349,20.2,1662.0
4480429854,1,13,1,1,7,4,6,1,1,0,0,16988,7.2,18623,196,56,1575,-516,19.6,1698.8,12,0,0,4,7,1,0,0,0,0,15413,7.2,19139,224,76,-1575,516,22.4,1541.3
4525562740,1,17,9,1,9,6,6,0,0,0,0,16749,6.6,17028,177,64,239,285,17.7,1674.9,19,6,0,6,9,5,0,0,0,0,16510,6.6,16743,219,59,-239,-285,21.9,1651.0
4521779426,1,13,2,1,7,5,12,1,1,0,0,17042,7.0,18045,223,60,1004,559,22.3,1704.2,12,2,0,5,7,9,0,0,0,0,16038,6.8,17486,182,48,-1004,-559,18.2,1603.8
4520328098,1,20,4,1,5,4,6,0,0,0,0,15887,6.8,16554,201,44,231,-446,20.1,1588.7,21,3,0,4,5,4,0,0,0,0,15656,6.4,17000,210,44,-231,446,21.0,1565.6
4426644547,1,14,4,1,7,7,6,0,0,0,1,19229,7.2,18820,257,62,3545,2162,25.7,1922.9,19,3,0,7,7,10,1,1,0,0,15684,6.6,16658,145,36,-3545,-2162,14.5,1568.4
4449074537,1,19,1,1,11,3,10,2,1,1,1,20259,7.0,19498,238,52,6210,3599,23.8,2025.9,36,3,0,3,11,4,0,0,0,0,14049,6.6,15899,180,52,-6210,-3599,18.0,1404.9
4510144910,1,16,6,0,5,6,5,0,0,0,0,16571,7.2,19112,212,66,-528,1756,21.2,1657.1,19,3,1,6,5,7,2,1,1,0,17099,6.6,17356,210,49,528,-1756,21.0,1709.9
4511226212,1,31,5,1,6,4,6,0,0,0,0,17631,7.0,18398,261,53,2803,2471,26.1,1763.1,18,5,0,4,6,7,1,0,1,0,14828,6.6,15927,188,46,-2803,-2471,18.8,1482.8
4484159432,1,41,3,1,11,3,15,1,1,0,0,19116,7.6,19542,223,36,3648,1867,22.3,1911.6,17,0,0,3,11,2,0,0,0,0,15468,7.0,17675,209,68,-3648,-1867,20.9,1546.8
4517940231,1,18,4,0,7,4,16,1,1,0,1,18539,7.0,18188,253,53,3466,1525,25.3,1853.9,25,2,1,4,7,2,1,0,1,0,15073,6.6,16663,222,42,-3466,-1525,22.2,1507.3
4492353523,1,13,2,1,7,6,7,0,0,0,0,16920,7.0,17906,204,60,1563,901,20.4,1692.0,16,3,0,6,7,8,0,0,0,0,15357,6.8,17005,178,56,-1563,-901,17.8,1535.7
4494820470,1,10,3,1,7,8,9,1,1,0,0,16890,6.8,17686,221,53,-1647,-1443,22.1,1689.0,11,1,0,8,7,9,1,0,1,0,18537,7.2,19129,223,60,1647,1443,22.3,1853.7
4521524486,1,16,3,1,5,5,7,0,0,0,0,16061,7.0,18238,210,60,530,1280,21.0,1606.1,14,2,0,5,5,5,0,0,0,0,15531,6.8,16958,204,44,-530,-1280,20.4,1553.1
4495401600,1,16,1,1,2,4,2,1,1,0,0,14402,7.0,17604,193,64,-1506,-500,19.3,1440.2,15,2,0,4,2,6,0,0,0,0,15908,6.8,18104,227,52,1506,500,22.7,1590.8
4436517463,1,13,0,1,5,4,6,0,0,0,0,15895,7.0,18344,239,38,42,367,23.9,1589.5,18,5,0,4,5,7,1,1,0,0,15853,6.8,17977,258,48,-42,-367,25.8,1585.3
4512768961,1,17,18,0,3,3,5,1,1,0,0,15704,7.2,18700,240,74,928,955,24.0,1570.4,63,1,1,3,3,1,0,0,0,0,14776,7.0,17745,232,45,-928,-955,23.2,1477.6
4510706463,1,18,1,1,4,1,2,1,1,0,0,17378,7.2,18286,262,60,3046,442,26.2,1737.8,13,2,0,1,4,2,0,0,0,0,14332,6.8,17844,211,64,-3046,-442,21.1,1433.2
4512489838,1,13,3,1,8,3,12,1,1,0,0,19038,7.2,18856,239,44,4034,1938,23.9,1903.8,16,2,0,3,8,4,0,0,0,0,15004,6.8,16918,228,49,-4034,-1938,22.8,1500.4
4452042195,1,17,2,1,2,3,4,0,0,0,0,16008,6.8,18674,237,83,1060,1708,23.7,1600.8,15,1,0,3,2,5,1,1,0,0,14948,6.8,16966,211,53,-1060,-1708,21.1,1494.8
4526734113,1,17,3,1,8,5,12,0,0,0,0,17469,7.0,18265,242,44,1625,121,24.2,1746.9,14,2,0,5,8,4,0,0,0,0,15844,6.8,18144,236,51,-1625,-121,23.6,1584.4
4461787791,1,89,3,1,7,5,7,1,1,0,0,17488,7.2,18635,220,51,1902,967,22.0,1748.8,54,6,0,5,7,6,0,0,0,0,15586,7.0,17668,193,60,-1902,-967,19.3,1558.6
4512466061,1,17,2,1,5,5,4,0,0,0,0,16092,6.8,18020,222,47,262,611,22.2,1609.2,15,0,0,5,5,7,1,1,0,0,15830,6.8,17409,191,62,-262,-611,19.1,1583.0
4446210050,1,38,3,1,3,3,0,1,1,0,0,14162,6.8,17402,201,54,-1078,692,20.1,1416.2,14,1,0,3,3,4,0,0,0,0,15240,6.8,16710,240,45,1078,-692,24.0,1524.0
4477447417,1,48,12,0,6,9,7,0,0,0,0,15993,6.8,18112,226,48,-1607,-215,22.6,1599.3,30,8,1,9,6,13,1,1,0,0,17600,7.0,18327,217,56,1607,215,21.7,1760.0
4449282228,1,12,4,0,5,4,7,1,1,0,0,16488,7.2,18632,220,60,1603,1827,22.0,1648.8,18,3,1,4,5,4,1,0,1,0,14885,6.6,16805,197,44,-1603,-1827,19.7,1488.5
4505476136,1,16,2,0,11,4,13,0,0,0,0,19582,7.4,19381,228,44,4267,2764,22.8,1958.2,16,2,1,4,11,2,0,0,0,0,15315,6.6,16617,200,50,-4267,-2764,20.0,1531.5
4522494083,1,15,3,1,12,5,13,0,0,0,0,19835,7.4,19690,223,48,4675,3054,22.3,1983.5,13,2,0,5,12,5,1,1,0,0,15160,6.8,16636,169,48,-4675,-3054,16.9,1516.0
4478461160,1,14,2,1,9,0,8,0,0,0,0,17086,7.2,19170,221,49,3655,2743,22.1,1708.6,37,2,0,0,9,0,1,1,0,0,13431,6.4,16427,198,60,-3655,-2743,19.8,1343.1
4496735855,1,16,3,1,7,2,9,0,0,0,0,16875,6.6,17964,222,49,2590,682,22.2,1687.5,15,1,0,2,7,1,1,1,0,0,14285,6.8,17282,225,54,-2590,-682,22.5,1428.5
4442547798,1,19,2,1,7,5,10,0,0,0,0,16491,6.8,17031,199,45,1774,1305,19.9,1649.1,19,2,0,5,7,5,0,0,0,0,14717,6.4,15726,170,34,-1774,-1305,17.0,1471.7
4510943404,1,23,1,1,7,6,9,0,0,0,0,16531,7.0,17534,218,40,-136,-290,21.8,1653.1,22,3,0,6,7,8,2,1,1,0,16667,7.0,17824,243,55,136,290,24.3,1666.7
4515910703,1,13,3,1,6,7,8,1,1,0,0,16682,6.8,17677,197,44,-970,-482,19.7,1668.2,18,4,0,7,6,8,0,0,0,0,17652,7.0,18159,227,43,970,482,22.7,1765.2
4519898107,1,14,2,0,7,2,12,2,1,1,0,18025,7.2,19864,261,68,3558,3243,26.1,1802.5,25,0,1,2,7,3,0,0,0,0,14467,6.8,16621,220,56,-3558,-3243,22.0,1446.7
4499622849,1,16,6,1,5,4,9,0,0,0,0,16415,6.8,17645,247,37,1626,747,24.7,1641.5,17,2,0,4,5,5,1,1,0,0,14789,7.0,16898,203,51,-1626,-747,20.3,1478.9
4527509662,1,17,2,1,7,2,8,1,1,0,0,17359,7.0,18203,219,65,3098,1882,21.9,1735.9,14,2,0,2,7,1,1,0,1,0,14261,6.4,16321,213,36,-3098,-1882,21.3,1426.1
4518322002,1,39,2,0,8,9,8,0,0,0,0,17389,7.0,18770,218,43,-1067,-523,21.8,1738.9,18,2,1,9,8,9,1,1,0,0,18456,7.4,19293,234,60,1067,523,23.4,1845.6
4501240960,1,16,2,0,5,5,6,1,1,0,0,16046,6.8,17207,234,41,699,18,23.4,1604.6,14,0,1,5,5,6,0,0,0,0,15347,6.6,17189,199,52,-699,-18,19.9,1534.7
4498660251,1,16,3,0,8,6,7,1,1,0,0,17104,7.0,18350,223,64,-111,1062,22.3,1710.4,36,2,1,6,8,8,1,0,1,1,17215,6.8,17288,201,48,111,-1062,20.1,1721.5
4518225344,1,14,6,1,5,5,6,1,1,0,0,16345,6.8,17499,246,45,134,-1022,24.6,1634.5,19,1,0,5,5,5,0,0,0,0,16211,7.2,18521,239,58,-134,1022,23.9,1621.1
4525167024,1,21,4,0,8,7,9,0,0,0,0,17737,7.2,18303,193,50,1083,451,19.3,1773.7,16,4,1,7,8,2,0,0,0,0,16654,7.2,17852,207,44,-1083,-451,20.7,1665.4
4521327659,1,13,2,1,8,3,9,1,1,0,0,17428,7.2,19729,220,50,2087,2578,22.0,1742.8,17,4,0,3,8,2,0,0,0,0,15341,6.8,17151,229,65,-2087,-2578,22.9,1534.1
4469947346,1,14,2,0,5,6,8,0,0,0,0,15577,6.6,16572,197,45,-1218,-1528,19.7,1557.7,16,2,1,6,5,11,2,1,1,0,16795,7.0,18100,239,64,1218,1528,23.9,1679.5
4502928407,1,19,1,0,14,10,24,1,1,0,0,20114,7.0,19069,220,34,2397,3292,22.0,2011.4,18,3,1,10,14,9,0,0,0,0,17717,6.4,15777,144,60,-2397,-3292,14.4,1771.7
4522399054,1,38,2,1,5,5,6,1,1,0,0,16794,6.8,17320,229,39,510,-747,22.9,1679.4,37,4,0,5,5,6,1,0,1,0,16284,7.2,18067,216,55,-510,747,21.6,1628.4
4518707192,1,36,5,1,8,3,10,1,1,0,0,17756,7.2,18394,231,43,2510,758,23.1,1775.6,13,2,0,3,8,3,0,0,0,0,15246,6.8,17636,218,68,-2510,-758,21.8,1524.6
4507328701,1,16,2,1,9,4,10,1,1,0,0,17779,7.2,19282,220,52,2178,1829,22.0,1777.9,11,2,0,4,9,2,0,0,0,0,15601,6.8,17453,244,56,-2178,-1829,24.4,1560.1
4523422751,1,15,2,1,8,0,8,2,1,1,0,18519,7.2,20004,235,52,5222,3469,23.5,1851.9,10,0,0,0,8,0,0,0,0,0,13297,6.6,16535,187,68,-5222,-3469,18.7,1329.7
4494477882,1,17,3,1,8,6,8,1,1,0,0,16563,7.2,18469,199,46,498,244,19.9,1656.3,14,2,0,6,8,2,0,0,0,0,16065,7.0,18225,209,41,-498,-244,20.9,1606.5
4527479817,1,36,3,0,3,5,2,2,1,1,0,15581,7.0,18847,233,72,-353,-280,23.3,1558.1,18,9,1,5,3,4,0,0,0,0,15934,7.4,19127,228,48,353,280,22.8,1593.4
4472387660,1,16,3,1,2,9,1,0,0,0,0,14975,6.4,16649,222,67,-2206,-2548,22.2,1497.5,18,3,0,9,2,12,1,1,0,0,17181,7.4,19197,216,48,2206,2548,21.6,1718.1
4527289282,1,13,4,0,3,9,3,0,0,0,0,15292,6.8,17170,223,55,-2513,-2247,22.3,1529.2,14,3,1,9,3,8,1,1,0,0,17805,7.2,19417,231,44,2513,2247,23.1,1780.5
4526616225,1,35,1,1,10,4,8,1,1,0,0,17637,7.0,18484,198,64,2216,949,19.8,1763.7,15,1,0,4,10,2,1,0,1,0,15421,6.8,17535,236,39,-2216,-949,23.6,1542.1
4478911331,1,14,4,0,12,5,23,1,1,0,0,18494,6.8,17736,212,43,3098,2685,21.2,1849.4,25,1,1,5,12,9,0,0,0,0,15396,6.2,15051,188,34,-3098,-2685,18.8,1539.6
4518121833,1,13,2,1,7,12,5,1,1,0,0,16544,6.8,17779,194,56,-3011,-1199,19.4,1654.4,16,0,0,12,7,20,0,0,0,0,19555,7.0,18978,222,36,3011,1199,22.2,1955.5
4481260961,1,15,2,0,5,5,5,0,0,0,0,15552,7.0,16960,211,44,726,-512,21.1,1555.2,16,3,1,5,5,3,1,1,0,0,14826,6.8,17472,192,42,-726,512,19.2,1482.6
4517524555,1,15,2,1,2,0,1,0,0,0,0,15486,7.0,18701,251,68,1386,1830,25.1,1548.6,18,3,0,0,2,0,0,0,0,0,14100,6.4,16871,234,54,-1386,-1830,23.4,1410.0
4509176495,1,18,3,1,8,6,11,0,0,0,0,16870,6.6,16180,212,44,829,-929,21.2,1687.0,19,5,0,6,8,5,1,1,0,0,16041,6.6,17109,245,46,-829,929,24.5,1604.1
4520529866,1,14,6,0,6,3,7,0,0,0,0,16590,7.2,19041,228,39,1214,2080,22.8,1659.0,16,1,1,3,6,2,1,1,0,0,15376,6.8,16961,224,66,-1214,-2080,22.4,1537.6
4526307631,1,14,2,0,6,4,8,1,1,0,0,17081,7.2,18350,226,58,2061,924,22.6,1708.1,18,2,1,4,6,3,0,0,0,0,15020,6.8,17426,218,44,-2061,-924,21.8,1502.0
4495408942,1,19,3,1,11,2,20,0,0,0,0,18963,7.4,19079,239,40,5337,3334,23.9,1896.3,15,4,0,2,11,2,1,1,0,0,13626,6.6,15745,179,44,-5337,-3334,17.9,1362.6
4526240730,1,16,2,1,10,11,18,1,1,0,0,18588,7.4,18787,205,65,432,1389,20.5,1858.8,20,3,0,11,10,12,0,0,0,0,18156,6.8,17398,186,45,-432,-1389,18.6,1815.6
4513780081,1,16,2,1,11,6,13,1,1,0,0,18136,7.0,18077,194,55,649,343,19.4,1813.6,15,3,0,6,11,8,0,0,0,0,17487,7.0,17734,239,44,-649,-343,23.9,1748.7
4503188502,1,20,9,1,6,6,6,0,0,0,0,16266,7.0,18203,208,40,1300,127,20.8,1626.6,27,7,0,6,6,4,1,1,0,0,14966,7.2,18076,155,66,-1300,-127,15.5,1496.6
4515453856,1,17,3,0,4,3,3,1,0,1,0,15227,7.0,18442,203,60,-513,992,20.3,1522.7,38,3,1,3,4,4,0,0,0,0,15740,7.0,17450,226,57,513,-992,22.6,1574.0
4455569547,1,11,1,1,9,7,10,0,0,0,0,17479,6.8,17898,209,52,1269,-422,20.9,1747.9,15,0,0,7,9,8,1,1,0,0,16210,6.8,18320,207,56,-1269,422,20.7,1621.0
4514505161,1,37,1,1,6,3,3,2,1,1,2,18742,7.4,20148,252,68,3725,2903,25.2,1874.2,12,14,0,3,6,5,0,0,0,0,15017,6.8,17245,208,52,-3725,-2903,20.8,1501.7
4519607934,1,44,3,1,7,5,4,1,1,0,0,16749,7.0,18142,192,60,976,2257,19.2,1674.9,13,2,0,5,7,8,0,0,0,0,15773,6.6,15885,209,35,-976,-2257,20.9,1577.3
4502793197,1,22,4,0,10,5,10,0,0,0,0,17987,7.4,19698,232,52,1810,2115,23.2,1798.7,72,2,1,5,10,4,1,0,1,0,16177,6.8,17583,222,56,-1810,-2115,22.2,1617.7
4499863965,1,11,2,0,8,10,8,0,0,0,0,16748,6.8,16907,178,44,-1579,-1715,17.8,1674.8,17,3,1,10,8,8,1,1,0,0,18327,7.2,18622,215,66,1579,1715,21.5,1832.7
4520399524,1,15,0,0,2,4,3,0,0,0,0,14808,6.8,16826,219,50,-1352,-2339,21.9,1480.8,14,3,1,4,2,5,0,0,0,0,16160,7.4,19165,257,51,1352,2339,25.7,1616.0
4524917684,1,16,2,0,8,9,6,0,0,0,1,18363,7.2,18592,224,52,321,368,22.4,1836.3,17,3,1,9,8,12,0,0,0,0,18042,7.0,18224,215,44,-321,-368,21.5,1804.2
4523383919,1,36,0,1,7,5,5,2,1,1,0,17538,7.4,19556,229,71,1652,1714,22.9,1753.8,12,4,0,5,7,4,0,0,0,0,15886,6.8,17842,209,48,-1652,-1714,20.9,1588.6
4516268505,1,42,2,1,8,3,6,0,0,0,0,16532,7.2,18420,229,40,1558,785,22.9,1653.2,34,2,0,3,8,2,1,0,1,0,14974,7.0,17635,206,56,-1558,-785,20.6,1497.4
4484160987,1,16,2,0,3,6,6,1,1,0,0,15335,6.6,17217,219,49,-839,-82,21.9,1533.5,14,2,1,6,3,5,0,0,0,0,16174,7.0,17299,225,36,839,82,22.5,1617.4
4497724425,1,15,1,1,16,5,14,1,1,0,0,19098,7.0,18636,203,37,2447,247,20.3,1909.8,11,0,0,5,16,3,0,0,0,0,16651,7.0,18389,207,63,-2447,-247,20.7,1665.1
4454611264,1,14,0,1,7,10,8,1,1,0,0,18089,7.4,18770,225,77,1158,191,22.5,1808.9,14,1,0,10,7,8,1,0,1,0,16931,7.2,18579,202,38,-1158,-191,20.2,1693.1
4517803168,1,20,3,1,13,6,12,0,0,0,0,19012,7.2,18944,210,54,2194,1814,21.0,1901.2,19,2,0,6,13,9,0,0,0,0,16818,6.8,17130,195,49,-2194,-1814,19.5,1681.8
4494811413,1,14,3,1,12,6,17,2,1,1,1,19993,7.0,17656,203,34,3439,913,20.3,1999.3,12,2,0,6,12,8,0,0,0,0,16554,6.8,16743,209,68,-3439,-913,20.9,1655.4
4494870999,1,17,3,1,5,0,4,1,0,1,1,17606,7.6,20053,229,60,4027,3285,22.9,1760.6,17,3,0,0,5,0,0,0,0,0,13579,6.6,16768,220,52,-4027,-3285,22.0,1357.9
4484391297,1,13,2,0,4,4,0,1,0,1,1,17079,7.4,19361,250,66,1680,2384,25.0,1707.9,50,2,1,4,4,3,0,0,0,0,15399,6.6,16977,200,62,-1680,-2384,20.0,1539.9
4458486391,1,18,7,1,9,5,7,1,1,0,0,17803,7.4,20184,267,39,2193,2957,26.7,1780.3,17,4,0,5,9,4,0,0,0,0,15610,6.8,17227,207,44,-2193,-2957,20.7,1561.0
4455468976,1,17,3,1,4,7,3,1,1,0,0,15859,7.0,18955,250,62,-898,-655,25.0,1585.9,17,5,0,7,4,9,0,0,0,0,16757,7.0,19610,193,59,898,655,19.3,1675.7
4526079366,1,38,2,1,7,6,6,0,0,0,0,17232,7.2,18525,238,54,672,411,23.8,1723.2,16,2,0,6,7,13,1,1,0,0,16560,7.0,18114,210,52,-672,-411,21.0,1656.0
4473400880,1,25,2,0,4,4,3,1,0,1,0,15551,6.8,17278,206,56,43,-1092,20.6,1555.1,17,5,1,4,4,2,1,1,0,0,15508,6.8,18370,218,65,-43,1092,21.8,1550.8
4512128800,1,14,2,1,6,6,11,0,0,0,0,16700,7.0,17393,218,40,1806,4,21.8,1670.0,14,1,0,6,6,3,1,1,0,0,14894,6.6,17389,203,39,-1806,-4,20.3,1489.4
4522469111,1,15,3,1,4,7,8,0,0,0,0,16002,6.6,16283,204,45,98,-786,20.4,1600.2,16,4,0,7,4,8,1,1,0,0,15904,6.6,17069,193,44,-98,786,19.3,1590.4
4482120889,1,18,2,1,11,5,11,2,1,1,0,18544,7.0,18246,213,44,3046,1162,21.3,1854.4,13,1,0,5,11,5,0,0,0,0,15498,6.6,17084,198,48,-3046,-1162,19.8,1549.8
4523305960,1,17,0,0,4,2,4,2,1,1,0,15752,7.2,19171,231,64,1064,2471,23.1,1575.2,54,2,1,2,4,4,0,0,0,0,14688,6.6,16700,235,44,-1064,-2471,23.5,1468.8
4516824896,1,22,2,0,8,4,9,0,0,0,0,16539,7.0,17585,205,46,1947,1396,20.5,1653.9,38,2,1,4,8,3,0,0,0,0,14592,6.6,16189,196,43,-1947,-1396,19.6,1459.2
4497864725,1,20,7,1,11,2,16,0,0,0,0,19770,7.2,19116,232,48,5120,3137,23.2,1977.0,16,3,0,2,11,2,2,1,1,0,14650,6.4,15979,191,64,-5120,-3137,19.1,1465.0
4517673973,1,49,1,1,8,2,10,1,1,0,1,18590,6.6,18032,237,48,3618,1086,23.7,1859.0,13,3,0,2,8,1,0,0,0,0,14972,6.6,16946,238,43,-3618,-1086,23.8,1497.2
4524424750,1,18,2,1,8,6,6,0,0,0,0,16691,6.8,16656,191,64,-1421,-1364,19.1,1669.1,25,6,0,6,8,7,0,0,0,1,18112,7.0,18020,237,51,1421,1364,23.7,1811.2
4524921520,1,25,1,0,5,5,4,0,0,0,0,17003,7.2,18752,252,59,570,368,25.2,1700.3,75,2,1,5,5,4,0,0,0,0,16433,7.2,18384,235,52,-570,-368,23.5,1643.3
4523653027,1,19,3,1,5,4,7,0,0,0,0,16989,7.0,18031,256,60,2000,1065,25.6,1698.9,16,4,0,4,5,7,1,1,0,0,14989,6.8,16966,206,51,-2000,-1065,20.6,1498.9
4433180879,1,38,2,0,5,7,6,1,1,0,0,15408,7.0,17993,209,52,-928,-1753,20.9,1540.8,19,2,1,7,5,3,0,0,0,0,16336,7.4,19746,237,56,928,1753,23.7,1633.6
4465354125,1,13,1,1,7,5,9,1,1,0,0,17627,7.0,19004,204,64,1794,927,20.4,1762.7,11,1,0,5,7,7,0,0,0,0,15833,7.0,18077,194,64,-1794,-927,19.4,1583.3
4458685012,1,15,3,1,9,3,11,0,0,0,0,18584,7.0,18383,203,70,3093,1285,20.3,1858.4,17,2,0,3,9,5,0,0,0,0,15491,6.8,17098,212,41,-3093,-1285,21.2,1549.1
4518444936,1,15,3,0,2,4,3,0,0,0,0,14716,6.8,17855,219,56,-839,63,21.9,1471.6,15,4,1,4,2,5,1,1,0,0,15555,7.0,17792,215,56,839,-63,21.5,1555.5
4459614716,1,53,6,1,4,3,5,0,0,0,0,16441,7.0,18447,244,52,1254,400,24.4,1644.1,18,3,0,3,4,4,0,0,0,0,15187,6.8,18047,218,60,-1254,-400,21.8,1518.7
4515902763,1,19,3,0,6,9,3,0,0,0,0,14947,6.6,16859,165,63,-2922,-2165,16.5,1494.7,12,6,1,9,6,6,1,1,0,0,17869,7.2,19024,239,44,2922,2165,23.9,1786.9
4518035441,1,17,0,0,4,7,4,2,1,1,0,15132,6.8,16489,190,64,-2022,-2023,19.0,1513.2,14,2,1,7,4,7,0,0,0,0,17154,7.2,18512,242,44,2022,2023,24.2,1715.4
4483893838,1,16,1,1,8,9,14,2,1,1,0,18532,7.2,18460,240,55,1428,295,24.0,1853.2,17,1,0,9,8,9,0,0,0,0,17104,7.0,18165,201,48,-1428,-295,20.1,1710.4
4473156943,1,14,0,0,6,9,7,0,0,0,0,15809,7.0,18227,202,62,-2167,-1158,20.2,1580.9,32,2,1,9,6,6,0,0,0,0,17976,7.2,19385,243,53,2167,1158,24.3,1797.6
4499933829,1,19,4,0,10,9,11,1,1,0,0,18413,7.2,18554,219,60,194,661,21.9,1841.3,13,2,1,9,10,12,0,0,0,0,18219,6.8,17893,230,36,-194,-661,23.0,1821.9
4524739692,1,15,3,0,7,6,9,1,1,0,1,18551,7.2,18363,225,61,1850,834,22.5,1855.1,18,1,1,6,7,7,0,0,0,0,16701,7.0,17529,210,57,-1850,-834,21.0,1670.1
4521092176,1,29,3,0,11,12,12,1,0,1,0,18983,6.8,17893,211,44,2457,255,21.1,1898.3,34,5,1,12,11,10,1,1,0,0,16526,7.0,17638,175,42,-2457,-255,17.5,1652.6
4468031280,1,17,5,0,5,3,8,1,1,0,0,15574,6.8,17788,230,45,840,196,23.0,1557.4,14,2,1,3,5,1,0,0,0,0,14734,7.0,17592,203,59,-840,-196,20.3,1473.4
4524364516,1,46,3,0,10,6,11,0,0,0,0,18582,7.4,19549,222,51,2230,2112,22.2,1858.2,42,17,1,6,10,8,1,0,1,0,16352,6.8,17437,196,43,-2230,-2112,19.6,1635.2
4524444788,1,14,1,1,5,6,4,0,0,0,0,16481,7.2,18268,221,53,563,-1127,22.1,1648.1,14,2,0,6,5,4,1,1,0,0,15918,7.2,19395,217,52,-563,1127,21.7,1591.8
4502131494,1,13,1,0,9,8,17,1,1,0,0,17923,7.0,17698,189,54,-37,-100,18.9,1792.3,14,1,1,8,9,9,0,0,0,0,17960,7.0,17798,202,60,37,100,20.2,1796.0
4462178191,1,19,2,1,7,0,9,1,1,0,1,18745,7.0,18917,259,48,4783,2851,25.9,1874.5,12,1,0,0,7,0,1,0,1,0,13962,6.4,16066,217,64,-4783,-2851,21.7,1396.2
4520893771,1,15,16,1,3,2,4,2,1,1,0,15698,7.0,18088,253,56,-451,-1374,25.3,1569.8,43,5,0,2,3,1,0,0,0,0,16149,7.2,19462,255,75,451,1374,25.5,1614.9
4516538758,1,12,9,0,2,5,3,2,1,1,0,14961,6.6,17746,210,56,-2377,-2713,21.0,1496.1,39,1,1,5,2,4,0,0,0,0,17338,7.6,20459,269,64,2377,2713,26.9,1733.8
4507594036,1,14,1,0,6,8,7,0,0,0,0,15818,6.6,16894,162,53,-1492,-1925,16.2,1581.8,13,2,1,8,6,5,1,1,0,0,17310,7.2,18819,214,56,1492,1925,21.4,1731.0
4520552077,1,17,2,0,6,6,9,0,0,0,0,17528,6.8,18106,216,55,1376,1018,21.6,1752.8,16,3,1,6,6,5,1,1,0,0,16152,6.8,17088,217,38,-1376,-1018,21.7,1615.2
4522475843,1,11,0,1,3,5,3,2,1,1,0,15562,6.8,16991,222,52,-1176,-1838,22.2,1556.2,16,2,0,5,3,9,0,0,0,0,16738,7.0,18829,201,68,1176,1838,20.1,1673.8
4526363486,1,20,3,0,4,8,5,1,1,0,0,15579,6.8,18054,203,67,-2227,-1077,20.3,1557.9,15,4,1,8,4,6,1,0,1,0,17806,7.2,19131,254,53,2227,1077,25.4,1780.6
4525783295,1,14,0,0,9,5,6,1,1,0,0,18912,7.4,20086,244,70,3970,2818,24.4,1891.2,10,0,1,5,9,5,0,0,0,0,14942,6.6,17268,210,29,-3970,-2818,21.0,1494.2
4494785966,1,14,3,0,4,6,7,1,0,1,0,16685,7.0,18643,236,71,289,-201,23.6,1668.5,18,2,1,6,4,4,1,1,0,0,16396,7.0,18844,234,52,-289,201,23.4,1639.6
4507879201,1,18,4,0,9,11,11,1,1,0,0,17909,7.0,18562,214,43,-292,-506,21.4,1790.9,16,3,1,11,9,13,0,0,0,0,18201,7.2,19068,205,52,292,506,20.5,1820.1
4452913051,1,19,1,1,6,3,6,2,1,1,0,17201,6.8,17943,186,67,2184,419,18.6,1720.1,48,3,0,3,6,4,0,0,0,0,15017,6.8,17524,211,52,-2184,-419,21.1,1501.7
4484379764,1,21,0,1,7,9,8,0,0,0,0,16076,6.8,16620,187,37,-923,-803,18.7,1607.6,14,4,0,9,7,11,1,1,0,0,16999,6.8,17423,197,52,923,803,19.7,1699.9
4472741177,1,25,6,1,10,1,7,1,0,1,0,19336,7.8,21123,267,52,6221,6143,26.7,1933.6,18,1,0,1,10,1,1,1,0,0,13115,6.2,14980,205,40,-6221,-6143,20.5,1311.5
4518221648,1,15,1,1,4,6,4,0,0,0,0,15298,6.6,16504,208,47,-1596,-1269,20.8,1529.8,13,2,0,6,4,10,1,1,0,0,16894,6.8,17773,210,52,1596,1269,21.0,1689.4
4452185923,1,18,2,0,6,9,10,0,0,0,0,17013,7.0,17832,246,42,-941,-1717,24.6,1701.3,16,2,1,9,6,7,0,0,0,0,17954,7.4,19549,240,40,941,1717,24.0,1795.4
4472113530,1,13,0,1,8,5,5,0,0,0,0,16979,7.2,18700,213,48,1486,991,21.3,1697.9,14,0,0,5,8,3,0,0,0,0,15493,7.0,17709,200,46,-1486,-991,20.0,1549.3
4494697495,1,15,1,0,10,5,8,1,1,0,0,17910,7.2,20300,211,60,2786,3197,21.1,1791.0,10,1,1,5,10,4,0,0,0,0,15124,6.8,17103,175,48,-2786,-3197,17.5,1512.4
4518160396,1,12,3,1,3,5,4,1,1,0,0,14323,6.6,16834,184,55,-2546,-2542,18.4,1432.3,14,3,0,5,3,5,1,0,1,0,16869,7.6,19376,243,70,2546,2542,24.3,1686.9
4506324067,1,19,5,0,4,3,8,1,1,0,0,15650,7.0,17837,224,51,-249,-1163,22.4,1565.0,15,2,1,3,4,3,1,0,1,0,15899,7.2,19000,254,58,249,1163,25.4,1589.9
4519269898,1,16,1,1,6,8,5,0,0,0,0,15969,6.8,17938,231,40,-809,10,23.1,1596.9,10,2,0,8,6,8,0,0,0,0,16778,6.6,17928,216,35,809,-10,21.6,1677.8
4499861497,1,15,2,1,5,5,6,1,0,1,0,16405,7.0,18502,239,43,861,1078,23.9,1640.5,14,2,0,5,5,9,1,1,0,0,15544,6.6,17424,233,44,-861,-1078,23.3,1554.4
4479288028,1,27,5,1,4,6,3,2,1,1,0,16485,7.2,19097,250,68,-264,315,25.0,1648.5,38,3,0,6,4,9,0,0,0,0,16749,7.2,18782,233,49,264,-315,23.3,1674.9
4508068981,1,11,4,1,6,4,4,1,1,0,0,17361,7.2,19308,208,72,1670,1765,20.8,1736.1,14,1,0,4,6,6,0,0,0,0,15691,6.8,17543,217,55,-1670,-1765,21.7,1569.1
4515310852,1,13,6,0,4,1,4,0,0,0,0,15809,7.0,19160,245,51,1219,1641,24.5,1580.9,16,3,1,1,4,0,1,1,0,0,14590,7.0,17519,244,62,-1219,-1641,24.4,1459.0
4461378771,1,16,2,1,11,10,8,1,0,1,0,18762,7.0,18724,202,40,1378,1187,20.2,1876.2,15,2,0,10,11,6,0,0,0,0,17384,7.0,17537,212,52,-1378,-1187,21.2,1738.4
4470363141,1,16,4,1,6,7,6,0,0,0,0,17035,7.2,18588,235,60,501,-495,23.5,1703.5,14,3,0,7,6,4,0,0,0,0,16534,7.0,19083,207,60,-501,495,20.7,1653.4
4523657645,1,16,5,0,5,4,5,1,0,1,0,15436,7.0,18911,220,48,-684,-742,22.0,1543.6,39,5,1,4,5,6,1,1,0,0,16120,7.2,19653,267,53,684,742,26.7,1612.0
4477827801,1,23,1,1,6,4,5,0,0,0,0,15983,7.2,19092,218,48,515,1403,21.8,1598.3,36,4,0,4,6,5,1,1,0,0,15468,6.8,17689,194,60,-515,-1403,19.4,1546.8
4520736346,1,13,2,1,11,9,9,0,0,0,0,17795,7.4,18920,164,63,-274,304,16.4,1779.5,14,1,0,9,11,9,0,0,0,0,18069,7.0,18616,237,46,274,-304,23.7,1806.9
4472795984,1,18,1,1,10,8,7,0,0,0,0,18380,7.2,18318,220,42,1938,1013,22.0,1838.0,12,2,0,8,10,9,0,0,0,0,16442,6.8,17305,189,48,-1938,-1013,18.9,1644.2
4494295244,1,17,5,0,7,7,8,0,0,0,0,16310,6.8,17712,219,44,464,426,21.9,1631.0,16,2,1,7,7,4,1,1,0,0,15846,6.8,17286,212,48,-464,-426,21.2,1584.6
4524250123,1,21,2,1,7,2,4,0,0,0,0,16631,7.2,19270,234,53,2088,1774,23.4,1663.1,28,0,0,2,7,3,1,1,0,0,14543,6.8,17496,209,64,-2088,-1774,20.9,1454.3
4525051331,1,15,5,0,8,4,12,1,1,0,0,17306,6.8,18073,237,43,2170,1383,23.7,1730.6,14,2,1,4,8,5,0,0,0,0,15136,6.4,16690,218,44,-2170,-1383,21.8,1513.6
4517647905,1,14,3,1,6,8,7,1,1,0,0,16058,7.0,17515,217,51,-677,-1382,21.7,1605.8,59,5,0,8,6,6,1,0,1,0,16735,7.2,18897,214,56,677,1382,21.4,1673.5
4508360116,1,37,3,1,6,5,7,1,1,0,0,16149,7.0,18253,217,44,-549,-323,21.7,1614.9,15,3,0,5,6,5,0,0,0,0,16698,6.8,18576,233,59,549,323,23.3,1669.8
4474892602,1,16,1,1,6,3,7,1,0,1,0,17167,6.8,18274,247,59,2089,1771,24.7,1716.7,11,2,0,3,6,4,1,1,0,0,15078,6.4,16503,202,50,-2089,-1771,20.2,1507.8
4494341320,1,16,3,1,4,2,8,1,1,0,0,16547,7.2,19666,259,64,1268,1705,25.9,1654.7,31,0,0,2,4,3,0,0,0,0,15279,7.0,17961,249,44,-1268,-1705,24.9,1527.9
4484850888,1,23,3,1,7,1,7,1,1,0,0,16850,7.2,19499,228,64,1994,1541,22.8,1685.0,44,1,0,1,7,2,1,0,1,0,14856,7.0,17958,224,58,-1994,-1541,22.4,1485.6
4490720316,1,38,2,1,9,6,12,0,0,0,0,18869,7.0,18526,206,74,4242,2348,20.6,1886.9,15,1,0,6,9,6,0,0,0,0,14627,6.6,16178,164,51,-4242,-2348,16.4,1462.7
4503029657,1,18,4,0,10,9,10,0,0,0,0,18209,6.8,16955,200,37,1287,440,20.0,1820.9,11,1,1,9,10,16,0,0,0,0,16922,6.2,16515,198,53,-1287,-440,19.8,1692.2
4463266834,1,14,3,0,6,6,10,1,1,0,0,16701,7.0,17762,196,56,-16,-467,19.6,1670.1,17,1,1,6,6,3,0,0,0,0,16717,7.2,18229,232,47,16,467,23.2,1671.7
4512836783,1,18,7,0,1,2,1,1,0,1,0,14583,6.6,17525,244,54,262,1643,24.4,1458.3,19,1,1,2,1,3,1,1,0,0,14321,6.4,15882,224,32,-262,-1643,22.4,1432.1
4513165995,1,17,7,1,7,4,6,1,1,0,0,17018,7.2,19495,238,40,1463,1571,23.8,1701.8,17,6,0,4,7,4,0,0,0,0,15555,7.0,17924,219,55,-1463,-1571,21.9,1555.5
4525810853,1,17,1,1,6,1,7,0,0,0,0,16561,7.4,19634,226,63,1852,2435,22.6,1656.1,16,2,0,1,6,2,1,1,0,0,14709,7.0,17199,238,60,-1852,-2435,23.8,1470.9
4526041586,1,18,2,0,9,5,11,0,0,0,0,17318,7.4,19732,221,52,1166,1899,22.1,1731.8,14,2,1,5,9,4,0,0,0,0,16152,7.0,17833,225,46,-1166,-1899,22.5,1615.2
4467040856,1,14,4,1,6,2,4,0,0,0,0,16636,7.2,18741,225,40,1833,899,22.5,1663.6,16,0,0,2,6,3,1,1,0,0,14803,6.8,17842,201,63,-1833,-899,20.1,1480.3
4470291861,1,16,2,0,12,7,19,1,1,0,1,20721,7.0,18605,247,49,4453,1296,24.7,2072.1,15,3,1,7,12,13,0,0,0,0,16268,7.0,17309,206,48,-4453,-1296,20.6,1626.8
4521675950,1,14,2,0,10,4,9,1,1,0,0,18779,7.2,19556,252,47,3679,2110,25.2,1877.9,60,0,1,4,10,3,0,0,0,0,15100,6.6,17446,203,56,-3679,-2110,20.3,1510.0
4506869531,1,18,0,1,3,7,5,0,0,0,0,14995,7.0,17661,240,50,-2442,-1250,24.0,1499.5,25,1,0,7,3,11,1,1,0,0,17437,7.2,18911,264,38,2442,1250,26.4,1743.7
4521835060,1,42,3,0,8,13,8,0,0,0,0,17639,6.6,16561,194,48,-887,-501,19.4,1763.9,51,5,1,13,8,20,1,1,0,0,18526,6.8,17062,198,36,887,501,19.8,1852.6
4465222745,1,14,2,0,4,6,9,0,0,0,0,15858,7.0,17780,215,54,-1050,522,21.5,1585.8,13,0,1,6,4,10,0,0,0,0,16908,6.8,17258,213,52,1050,-522,21.3,1690.8
4486499465,1,14,4,1,7,9,7,0,0,0,0,16149,6.4,16018,186,48,-393,-478,18.6,1614.9,15,1,0,9,7,7,0,0,0,0,16542,6.4,16496,173,48,393,478,17.3,1654.2
4525215598,1,57,3,0,6,9,6,1,1,0,0,15824,6.6,16324,210,41,-2047,-2330,21.0,1582.4,19,3,1,9,6,8,1,0,1,0,17871,6.8,18654,205,64,2047,2330,20.5,1787.1
4525248629,1,34,3,1,8,5,9,1,1,0,0,16840,7.2,18289,185,74,1015,1543,18.5,1684.0,79,3,0,5,8,7,1,0,1,0,15825,6.6,16746,195,38,-1015,-1543,19.5,1582.5
4472131666,1,17,4,1,5,3,3,0,0,0,0,16400,7.4,18900,255,62,2247,1439,25.5,1640.0,41,4,0,3,5,1,1,1,0,0,14153,7.0,17461,202,54,-2247,-1439,20.2,1415.3
4522394082,1,19,14,1,8,3,11,1,1,0,0,18200,7.2,19337,218,67,3719,1813,21.8,1820.0,62,3,0,3,8,1,0,0,0,0,14481,6.8,17524,214,60,-3719,-1813,21.4,1448.1
4516498052,1,16,2,0,9,9,10,0,0,0,1,18181,6.6,17078,202,36,1520,1110,20.2,1818.1,37,4,1,9,9,14,0,0,0,0,16661,6.6,15968,165,31,-1520,-1110,16.5,1666.1
4515211180,1,15,2,1,5,4,1,2,1,1,0,15917,7.0,18370,211,64,805,691,21.1,1591.7,13,3,0,4,5,4,0,0,0,0,15112,6.8,17679,187,60,-805,-691,18.7,1511.2
4513352439,1,20,5,1,4,5,3,0,0,0,0,16083,6.8,18268,264,53,80,-609,26.4,1608.3,67,2,0,5,4,8,1,1,0,0,16003,7.2,18877,225,53,-80,609,22.5,1600.3
4455236483,1,18,4,1,4,1,6,1,1,0,0,16448,7.2,18932,248,61,1306,431,24.8,1644.8,14,3,0,1,4,2,0,0,0,0,15142,7.0,18501,262,64,-1306,-431,26.2,1514.2
4475474933,1,14,4,1,8,4,7,0,0,0,1,17634,6.8,17330,219,45,1930,425,21.9,1763.4,17,1,0,4,8,5,0,0,0,0,15704,6.4,16905,226,46,-1930,-425,22.6,1570.4
4503044010,1,21,2,1,10,4,14,2,1,1,0,18132,6.8,17869,212,42,1947,136,21.2,1813.2,22,5,0,4,10,3,0,0,0,0,16185,6.6,17733,219,49,-1947,-136,21.9,1618.5
4490705012,1,15,2,0,10,10,11,0,0,0,0,17528,6.8,17194,197,34,-541,546,19.7,1752.8,15,4,1,10,10,11,1,1,0,0,18069,6.6,16648,223,36,541,-546,22.3,1806.9
4519789324,1,15,1,0,6,5,2,1,1,0,0,15967,7.0,18611,237,56,-999,-778,23.7,1596.7,10,3,1,5,6,5,1,0,1,0,16966,7.2,19389,250,54,999,778,25.0,1696.6
4513689722,1,12,4,0,5,1,5,0,0,0,0,17512,7.4,20540,283,67,3122,3276,28.3,1751.2,13,0,1,1,5,1,1,1,0,0,14390,6.6,17264,244,40,-3122,-3276,24.4,1439.0
4519166800,1,17,4,0,7,4,6,1,1,0,0,17329,7.4,19569,239,54,1257,1123,23.9,1732.9,14,2,1,4,7,3,0,0,0,0,16072,7.2,18446,242,57,-1257,-1123,24.2,1607.2
4524378471,1,16,5,0,11,10,10,1,1,0,0,18720,7.2,18913,222,44,-438,-669,22.2,1872.0,37,1,1,10,11,12,0,0,0,0,19158,7.2,19582,186,64,438,669,18.6,1915.8
4522793625,1,18,1,1,7,4,16,1,1,0,0,16282,6.4,16018,173,57,2062,1120,17.3,1628.2,16,1,0,4,7,9,0,0,0,0,14220,6.4,14898,174,44,-2062,-1120,17.4,1422.0
4525936315,1,54,4,1,7,9,6,1,1,0,0,16437,6.8,16958,195,48,-222,17,19.5,1643.7,18,6,0,9,7,12,0,0,0,0,16659,6.8,16941,208,34,222,-17,20.8,1665.9
4524625875,1,43,2,1,2,6,2,0,0,0,0,14959,7.0,17503,229,48,-2128,-1289,22.9,1495.9,84,5,0,6,2,7,1,1,0,0,17087,7.2,18792,219,51,2128,1289,21.9,1708.7
4446121207,1,39,4,1,12,6,19,0,0,0,1,20560,7.4,19784,216,52,4426,2385,21.6,2056.0,15,3,0,6,12,6,0,0,0,0,16134,6.6,17399,206,60,-4426,-2385,20.6,1613.4
4497520104,1,141,2,0,6,6,6,0,0,0,0,16830,7.0,18944,226,51,708,1208,22.6,1683.0,18,2,1,6,6,4,2,1,1,0,16122,6.8,17736,204,54,-708,-1208,20.4,1612.2
4520934653,1,14,2,0,8,3,8,0,0,0,0,16847,7.2,18705,195,68,1255,2754,19.5,1684.7,13,0,1,3,8,2,0,0,0,0,15592,6.4,15951,247,33,-1255,-2754,24.7,1559.2
4465719445,1,21,3,1,10,5,12,1,1,0,0,18046,7.4,19739,226,52,2299,1804,22.6,1804.6,17,6,0,5,10,5,0,0,0,0,15747,7.2,17935,229,48,-2299,-1804,22.9,1574.7
4496792553,1,16,3,0,8,7,13,0,0,0,0,16366,6.8,17010,196,34,-963,-457,19.6,1636.6,16,2,1,7,8,8,0,0,0,0,17329,7.0,17467,220,52,963,457,22.0,1732.9
4462313921,1,57,4,1,17,5,25,0,0,0,2,23359,7.4,20348,237,56,7776,6703,23.7,2335.9,14,5,0,5,17,7,0,0,0,0,15583,5.8,13645,134,41,-7776,-6703,13.4,1558.3
4499941811,1,11,1,1,8,11,6,1,1,0,0,16836,6.6,16495,215,41,-1521,-2096,21.5,1683.6,18,3,0,11,8,12,0,0,0,0,18357,7.0,18591,215,51,1521,2096,21.5,1835.7
4517721130,1,15,3,1,6,3,6,1,1,0,0,17202,7.4,19917,229,64,1360,2274,22.9,1720.2,83,0,0,3,6,3,0,0,0,0,15842,7.0,17643,220,52,-1360,-2274,22.0,1584.2
4443689481,1,19,3,1,9,6,8,1,1,0,0,17344,6.8,17484,191,48,992,-609,19.1,1734.4,14,0,0,6,9,6,0,0,0,0,16352,7.0,18093,206,57,-992,609,20.6,1635.2
4507834811,1,18,1,0,8,6,9,1,1,0,0,17178,7.0,17854,209,44,1260,-55,20.9,1717.8,10,3,1,6,8,3,0,0,0,0,15918,6.8,17909,233,36,-1260,55,23.3,1591.8
4513430767,1,14,1,1,6,4,12,1,1,0,0,16189,6.8,17737,224,39,625,-534,22.4,1618.9,102,1,0,4,6,4,0,0,0,0,15564,7.0,18271,217,48,-625,534,21.7,1556.4
4477446374,1,38,4,0,3,1,0,1,1,0,0,15594,7.4,20342,241,72,1402,2404,24.1,1559.4,14,2,1,1,3,1,0,0,0,0,14192,6.8,17938,215,59,-1402,-2404,21.5,1419.2
4450437970,1,35,0,1,6,4,4,2,1,1,0,15997,7.2,19158,195,60,499,2441,19.5,1599.7,21,1,0,4,6,4,0,0,0,0,15498,6.6,16717,210,41,-499,-2441,21.0,1549.8
4519008578,1,68,2,1,7,9,8,0,0,0,0,16274,6.8,17652,204,41,-1248,-843,20.4,1627.4,14,1,0,9,7,13,0,0,0,0,17522,7.2,18495,211,41,1248,843,21.1,1752.2
4476670198,1,17,3,0,3,8,3,1,1,0,0,14591,6.8,16795,224,46,-3236,-2874,22.4,1459.1,16,3,1,8,3,8,1,0,1,0,17827,7.4,19669,252,50,3236,2874,25.2,1782.7
4488784073,1,37,4,0,6,10,6,0,0,0,0,16413,7.0,17648,204,49,-2461,-1828,20.4,1641.3,16,4,1,10,6,13,1,1,0,0,18874,7.4,19476,223,64,2461,1828,22.3,1887.4
4518341446,1,17,6,1,4,2,6,0,0,0,0,16068,6.6,17607,235,52,932,-534,23.5,1606.8,20,2,0,2,4,2,0,0,0,0,15136,7.0,18141,241,58,-932,534,24.1,1513.6
4516700251,1,38,5,0,8,3,9,1,1,0,0,17328,7.2,19304,228,69,2357,2202,22.8,1732.8,17,3,1,3,8,2,0,0,0,0,14971,6.8,17102,222,44,-2357,-2202,22.2,1497.1
4503471693,1,20,6,0,4,7,3,0,0,0,0,15434,7.0,18097,235,49,-1806,-226,23.5,1543.4,20,4,1,7,4,12,1,1,0,0,17240,7.2,18323,224,58,1806,226,22.4,1724.0
4508799837,1,16,1,0,6,4,6,1,0,1,1,18625,7.4,19348,240,50,3163,1231,24.0,1862.5,16,2,1,4,6,6,1,1,0,0,15462,7.0,18117,230,46,-3163,-1231,23.0,1546.2
4518069605,1,77,2,0,4,3,7,1,1,0,0,16321,7.0,18950,250,52,508,-183,25.0,1632.1,15,4,1,3,4,7,0,0,0,0,15813,7.0,19133,225,74,-508,183,22.5,1581.3
4513659077,1,16,3,0,4,4,3,1,1,0,0,15024,7.0,17340,217,49,-1243,-1261,21.7,1502.4,15,3,1,4,4,6,1,0,1,0,16267,7.0,18601,221,62,1243,1261,22.1,1626.7
4501540670,1,79,2,1,7,7,4,0,0,0,1,18053,7.4,19492,230,41,891,1526,23.0,1805.3,14,1,0,7,7,11,1,1,0,0,17162,7.0,17966,202,54,-891,-1526,20.2,1716.2
4467282089,1,15,3,1,8,4,6,1,0,1,0,17522,7.2,18612,257,42,2392,511,25.7,1752.2,19,5,0,4,8,1,0,0,0,0,15130,7.0,18101,222,69,-2392,-511,22.2,1513.0
4525301191,1,12,2,0,6,8,6,0,0,0,0,16047,6.8,18460,250,32,-518,-268,25.0,1604.7,16,3,1,8,6,3,2,1,1,0,16565,7.2,18728,211,47,518,268,21.1,1656.5
4485773420,1,38,3,0,4,5,4,1,1,0,0,15184,6.8,17545,199,48,-700,906,19.9,1518.4,16,0,1,5,4,5,1,0,1,0,15884,6.6,16639,215,38,700,-906,21.5,1588.4
4455128161,1,18,2,1,13,2,16,1,1,0,0,19773,7.6,20507,240,40,5622,3964,24.0,1977.3,13,3,0,2,13,4,0,0,0,0,14151,6.6,16543,203,64,-5622,-3964,20.3,1415.1
4490735415,1,17,3,0,7,4,5,1,1,0,0,16819,7.2,18725,239,60,707,1960,23.9,1681.9,37,2,1,4,7,3,0,0,0,0,16112,6.8,16765,198,52,-707,-1960,19.8,1611.2
4438236114,1,14,1,1,10,8,10,0,0,0,0,17949,7.0,19069,200,47,1052,340,20.0,1794.9,28,2,0,8,10,6,1,1,0,0,16897,7.0,18729,223,60,-1052,-340,22.3,1689.7
4521683040,1,40,8,1,6,6,14,1,1,0,0,16805,7.0,18793,230,63,11,64,23.0,1680.5,29,4,0,6,6,7,0,0,0,0,16794,7.2,18729,223,56,-11,-64,22.3,1679.4
4482075284,1,12,3,1,8,2,8,0,0,0,0,18269,7.6,20290,258,49,3389,3465,25.8,1826.9,15,3,0,2,8,1,0,0,0,0,14880,6.4,16825,239,50,-3389,-3465,23.9,1488.0
4459966924,1,15,3,1,5,1,5,0,0,0,0,16618,7.2,19643,250,52,2263,1451,25.0,1661.8,16,1,0,1,5,1,0,0,0,0,14355,6.8,18192,243,52,-2263,-1451,24.3,1435.5
4513532408,1,85,6,1,6,3,5,2,1,1,0,18596,7.0,19244,254,71,4633,3451,25.4,1859.6,16,2,0,3,6,3,0,0,0,0,13963,6.6,15793,192,33,-4633,-3451,19.2,1396.3
4457247520,1,122,2,1,15,10,9,1,0,1,0,19204,7.6,20520,215,54,1902,3370,21.5,1920.4,13,4,0,10,15,12,0,0,0,0,17302,6.8,17150,183,27,-1902,-3370,18.3,1730.2
4524077612,1,12,1,0,6,6,2,1,0,1,1,16753,6.8,17350,190,61,1936,1799,19.0,1675.3,10,0,1,6,6,3,1,1,0,0,14817,6.0,15551,190,57,-1936,-1799,19.0,1481.7
4523781567,1,10,3,0,5,5,4,0,0,0,0,16368,7.0,18622,250,48,1079,1363,25.0,1636.8,14,3,1,5,5,7,1,1,0,0,15289,7.0,17259,206,56,-1079,-1363,20.6,1528.9
4496436861,1,14,16,1,8,2,9,0,0,0,0,16708,7.2,18529,230,41,1860,1500,23.0,1670.8,41,4,0,2,8,3,0,0,0,0,14848,6.6,17029,226,50,-1860,-1500,22.6,1484.8
4520353212,1,15,2,0,6,4,8,0,0,0,0,17201,7.2,19652,239,57,1820,1893,23.9,1720.1,12,2,1,4,6,5,1,1,0,0,15381,7.0,17759,219,58,-1820,-1893,21.9,1538.1
4517721011,1,15,4,0,8,9,4,0,0,0,0,16566,7.2,18723,214,48,-1838,-1127,21.4,1656.6,16,1,1,9,8,7,2,1,1,0,18404,7.2,19850,238,60,1838,1127,23.8,1840.4
4479823004,1,18,1,0,13,9,18,1,1,0,0,19032,7.4,18951,232,44,527,721,23.2,1903.2,12,4,1,9,13,5,0,0,0,0,18505,7.0,18230,216,63,-527,-721,21.6,1850.5
4508101367,1,14,2,0,6,4,5,0,0,0,0,16637,7.0,19339,245,49,1530,2305,24.5,1663.7,25,3,1,4,6,5,1,1,0,0,15107,6.6,17034,216,48,-1530,-2305,21.6,1510.7
4514409289,1,12,8,1,8,7,7,1,1,0,0,16840,7.2,19004,193,51,-144,-157,19.3,1684.0,42,3,0,7,8,7,0,0,0,0,16984,7.2,19161,218,56,144,157,21.8,1698.4
4510990676,1,19,2,1,10,2,12,1,0,1,0,19621,7.6,19733,209,56,6703,5604,20.9,1962.1,18,3,0,2,10,2,0,0,0,0,12918,5.8,14129,140,58,-6703,-5604,14.0,1291.8
4520540286,1,19,6,0,4,5,5,1,1,0,0,16331,7.2,18927,246,60,-462,542,24.6,1633.1,18,5,1,5,4,8,0,0,0,0,16793,6.8,18385,273,49,462,-542,27.3,1679.3
4480057032,1,18,3,1,12,4,16,1,1,0,0,19351,7.4,20590,220,40,3969,3522,22.0,1935.1,14,2,0,4,12,4,0,0,0,0,15382,6.6,17068,221,48,-3969,-3522,22.1,1538.2
4522649114,1,23,5,1,5,2,9,0,0,0,0,15904,7.0,17670,213,48,1085,-556,21.3,1590.4,20,2,0,2,5,1,0,0,0,0,14819,6.8,18226,229,64,-1085,556,22.9,1481.9
4515979175,1,15,1,1,4,4,5,1,0,1,0,15547,7.2,17921,208,44,256,241,20.8,1554.7,22,6,0,4,4,2,1,1,0,0,15291,6.8,17680,222,49,-256,-241,22.2,1529.1
4513902880,1,11,1,1,5,2,4,0,0,0,0,14945,6.8,17524,168,48,-145,850,16.8,1494.5,16,3,0,2,5,2,1,1,0,0,15090,6.6,16674,233,48,145,-850,23.3,1509.0
4482189285,1,15,1,1,7,0,6,1,1,0,0,18039,7.2,18984,236,64,4991,3364,23.6,1803.9,13,0,0,0,7,0,0,0,0,0,13048,6.2,15620,193,44,-4991,-3364,19.3,1304.8
4459102512,1,15,1,1,9,6,12,0,0,0,0,17027,6.8,17004,175,49,573,48,17.5,1702.7,16,2,0,6,9,11,0,0,0,0,16454,7.0,16956,191,56,-573,-48,19.1,1645.4
4511383179,1,14,4,1,5,2,5,2,1,1,0,16627,6.8,18676,223,50,2359,1681,22.3,1662.7,14,3,0,2,5,3,0,0,0,0,14268,6.6,16995,221,45,-2359,-1681,22.1,1426.8
4511150138,1,40,5,0,3,4,3,1,1,0,0,15458,7.2,19132,219,64,98,984,21.9,1545.8,16,3,1,4,3,2,0,0,0,0,15360,7.0,18148,240,48,-98,-984,24.0,1536.0
4513212030,1,16,3,1,6,5,5,0,0,0,1,16529,6.8,16649,198,52,1085,775,19.8,1652.9,17,3,0,5,6,8,1,1,0,0,15444,6.4,15874,179,55,-1085,-775,17.9,1544.4
4462628331,1,13,6,1,7,11,8,0,0,0,0,16749,6.8,17223,226,47,-2320,-1204,22.6,1674.9,37,2,0,11,7,12,2,1,1,0,19069,6.8,18427,207,60,2320,1204,20.7,1906.9
4526597273,1,89,2,1,11,7,14,0,0,0,0,19866,7.6,20339,202,53,3128,2919,20.2,1986.6,15,2,0,7,11,5,0,0,0,0,16738,6.8,17420,202,48,-3128,-2919,20.2,1673.8
4496068567,1,13,2,1,9,5,6,1,0,1,0,17076,7.2,18945,194,54,834,1853,19.4,1707.6,16,0,0,5,9,2,0,0,0,0,16242,6.6,17092,238,36,-834,-1853,23.8,1624.2
4483310485,1,19,2,0,2,1,3,1,1,0,0,14909,7.0,18031,245,52,410,720,24.5,1490.9,14,3,1,1,2,1,0,0,0,0,14499,6.8,17311,237,52,-410,-720,23.7,1449.9
4514142967,1,18,2,0,10,12,15,1,1,0,0,17877,6.8,17302,186,43,-920,-1562,18.6,1787.7,19,3,1,12,10,9,1,0,1,0,18797,7.2,18864,231,40,920,1562,23.1,1879.7
4506337812,1,41,1,1,7,3,6,1,1,0,0,18195,7.4,20319,252,64,4197,3107,25.2,1819.5,14,3,0,3,7,1,1,0,1,0,13998,6.8,17212,187,53,-4197,-3107,18.7,1399.8
4511941552,1,17,6,0,8,2,9,1,1,0,0,16699,7.0,18113,238,36,1718,1073,23.8,1669.9,16,3,1,2,8,3,0,0,0,0,14981,6.8,17040,225,56,-1718,-1073,22.5,1498.1
4525326999,1,40,3,1,3,3,3,1,1,0,0,14977,7.0,17698,223,44,98,161,22.3,1497.7,15,19,0,3,3,4,0,0,0,0,14879,6.8,17537,224,44,-98,-161,22.4,1487.9
4517653649,1,93,2,0,16,8,27,0,0,0,0,21663,7.4,19484,226,48,3825,2747,22.6,2166.3,14,5,1,8,16,15,0,0,0,0,17838,6.4,16737,216,55,-3825,-2747,21.6,1783.8
4479492497,1,12,2,1,14,6,10,1,0,1,1,20225,6.6,17976,194,50,4453,2458,19.4,2022.5,17,2,0,6,14,6,1,1,0,0,15772,6.6,15518,189,40,-4453,-2458,18.9,1577.2
4500335888,1,14,2,0,7,4,5,1,1,0,0,17052,7.2,19250,234,64,1648,1881,23.4,1705.2,16,3,1,4,7,4,0,0,0,0,15404,6.6,17369,223,38,-1648,-1881,22.3,1540.4
4462971469,1,17,4,1,8,5,8,1,1,0,0,17610,7.4,18827,221,55,1677,809,22.1,1761.0,15,3,0,5,8,5,0,0,0,0,15933,7.2,18018,212,64,-1677,-809,21.2,1593.3
4527319271,1,93,1,0,17,4,25,2,1,1,0,21257,7.4,20163,220,48,6713,5380,22.0,2125.7,10,3,1,4,17,3,0,0,0,0,14544,6.2,14783,170,51,-6713,-5380,17.0,1454.4
4524668512,1,19,5,1,6,9,8,1,0,1,0,16711,7.0,17375,217,52,-927,-200,21.7,1671.1,18,3,0,9,6,10,1,1,0,0,17638,6.8,17575,229,46,927,200,22.9,1763.8
4508899687,1,16,3,0,3,3,1,0,0,0,0,15379,7.0,17670,232,48,236,-37,23.2,1537.9,16,6,1,3,3,5,1,1,0,0,15143,6.8,17707,217,52,-236,37,21.7,1514.3
4511306202,1,17,0,1,5,3,4,0,0,0,0,15833,7.0,17979,196,68,1284,25,19.6,1583.3,11,3,0,3,5,0,2,1,1,0,14549,6.8,17954,202,56,-1284,-25,20.2,1454.9
4523323599,1,20,10,0,9,11,10,1,0,1,0,17298,6.8,17146,198,40,-98,-169,19.8,1729.8,47,5,1,11,9,13,1,1,0,0,17396,7.0,17315,182,36,98,169,18.2,1739.6
4503626292,1,15,1,1,14,4,14,0,0,0,0,19600,7.4,20132,218,56,5344,3506,21.8,1960.0,12,1,0,4,14,1,0,0,0,0,14256,6.8,16626,194,47,-5344,-3506,19.4,1425.6
4479811257,1,26,4,0,5,10,8,0,0,0,0,15710,6.6,16731,205,46,-3731,-1458,20.5,1571.0,16,3,1,10,5,11,1,1,0,0,19441,7.2,18189,230,51,3731,1458,23.0,1944.1
4513433271,1,81,2,0,4,7,4,1,1,0,0,15746,7.0,17836,195,62,-1556,286,19.5,1574.6,47,5,1,7,4,6,0,0,0,0,17302,6.8,17550,237,53,1556,-286,23.7,1730.2
4515644857,1,15,3,1,8,10,5,1,1,0,0,16480,7.0,17338,183,44,-1428,-1532,18.3,1648.0,28,3,0,10,8,10,0,0,0,0,17908,7.4,18870,192,56,1428,1532,19.2,1790.8
4452482397,1,15,4,1,4,4,3,0,0,0,0,14559,6.8,17491,191,44,-1348,-10,19.1,1455.9,91,2,0,4,4,6,1,0,1,0,15907,6.6,17501,202,54,1348,10,20.2,1590.7
4518209107,1,13,3,0,13,9,12,1,1,0,0,20541,7.4,19687,260,60,2368,1767,26.0,2054.1,28,3,1,9,13,16,0,0,0,0,18173,6.8,17920,169,52,-2368,-1767,16.9,1817.3
4479476013,1,15,2,0,7,4,9,0,0,0,0,16556,6.6,16868,215,36,2139,850,21.5,1655.6,12,3,1,4,7,4,1,1,0,0,14417,6.4,16018,176,47,-2139,-850,17.6,1441.7
4524850918,1,38,4,1,8,9,10,1,0,1,0,17558,6.8,17905,202,44,-483,-427,20.2,1755.8,56,4,0,9,8,9,1,1,0,0,18041,7.2,18332,205,48,483,427,20.5,1804.1
4521277262,1,19,3,1,10,6,11,1,1,0,0,17777,7.2,18131,213,42,1201,316,21.3,1777.7,18,4,0,6,10,5,0,0,0,0,16576,6.8,17815,234,44,-1201,-316,23.4,1657.6
4474739496,1,15,5,1,8,4,10,1,1,0,0,17640,7.0,18174,207,55,4035,3311,20.7,1764.0,51,3,0,4,8,9,0,0,0,0,13605,6.0,14863,155,40,-4035,-3311,15.5,1360.5
4525085237,1,12,1,1,2,5,1,1,1,0,0,14936,7.2,17688,231,53,-1543,-509,23.1,1493.6,14,2,0,5,2,8,0,0,0,0,16479,7.0,18197,250,40,1543,509,25.0,1647.9
4523093553,1,17,3,1,9,4,8,1,1,0,0,18646,7.6,19823,253,43,3767,3277,25.3,1864.6,11,2,0,4,9,6,0,0,0,0,14879,6.6,16546,195,36,-3767,-3277,19.5,1487.9
4298181346,1,18,7,1,8,6,8,1,1,0,0,17505,7.2,19310,223,59,786,1888,22.3,1750.5,17,2,0,6,8,7,0,0,0,0,16719,6.6,17422,220,44,-786,-1888,22.0,1671.9
4501354453,1,43,2,1,5,4,5,1,0,1,0,17027,6.8,17816,213,56,508,-1704,21.3,1702.7,14,2,0,4,5,4,1,1,0,0,16519,7.4,19520,231,75,-508,1704,23.1,1651.9
4511683364,1,19,5,0,4,3,3,0,0,0,0,15832,7.2,18431,257,52,755,436,25.7,1583.2,17,4,1,3,4,4,2,1,1,0,15077,7.0,17995,217,60,-755,-436,21.7,1507.7
4500216445,1,18,2,1,8,7,10,0,0,0,0,17450,7.2,18989,236,52,270,638,23.6,1745.0,17,4,0,7,8,5,1,0,1,0,17180,6.8,18351,220,48,-270,-638,22.0,1718.0
4479318487,1,14,4,0,6,3,6,0,0,0,0,16061,6.8,17186,158,60,1195,538,15.8,1606.1,37,6,1,3,6,1,1,1,0,0,14866,6.6,16648,210,56,-1195,-538,21.0,1486.6
4522252043,1,13,0,1,6,3,8,0,0,0,0,18236,7.2,19626,234,76,3586,3431,23.4,1823.6,13,1,0,3,6,4,0,0,0,0,14650,6.6,16195,221,47,-3586,-3431,22.1,1465.0
4526352878,1,18,3,0,9,11,16,0,0,0,0,17174,6.8,16698,186,33,-1682,-2102,18.6,1717.4,20,3,1,11,9,15,1,1,0,0,18856,7.2,18800,221,81,1682,2102,22.1,1885.6
4487406430,1,18,5,0,10,4,14,1,1,0,0,18541,7.0,18196,210,48,4362,2989,21.0,1854.1,43,3,1,4,10,2,0,0,0,0,14179,6.4,15207,176,30,-4362,-2989,17.6,1417.9
4516387872,1,17,4,1,12,4,18,1,1,0,0,19640,7.0,18636,216,52,5151,3496,21.6,1964.0,10,1,0,4,12,5,0,0,0,0,14489,6.0,15140,175,36,-5151,-3496,17.5,1448.9
4477571512,1,15,7,1,8,4,12,1,1,0,0,16819,6.8,17190,199,58,1896,1069,19.9,1681.9,24,2,0,4,8,5,0,0,0,0,14923,6.6,16121,216,41,-1896,-1069,21.6,1492.3
4475259574,1,15,3,1,2,3,2,1,1,0,0,14535,6.4,16699,234,35,-988,-1427,23.4,1453.5,16,1,0,3,2,4,1,0,1,0,15523,7.0,18126,241,48,988,1427,24.1,1552.3
4521111365,1,17,2,1,3,7,3,1,1,0,0,14849,6.8,17502,221,53,-3736,-2032,22.1,1484.9,16,2,0,7,3,6,1,0,1,1,18585,7.6,19534,232,60,3736,2032,23.2,1858.5
4521806282,1,16,0,1,8,6,4,0,0,0,0,16818,7.0,18842,213,52,588,1104,21.3,1681.8,12,0,0,6,8,7,1,1,0,0,16230,7.0,17738,232,45,-588,-1104,23.2,1623.0
4522086611,1,17,2,0,5,5,4,1,1,0,0,16660,7.0,19188,217,55,785,1439,21.7,1666.0,18,2,1,5,5,6,0,0,0,0,15875,6.8,17749,200,48,-785,-1439,20.0,1587.5
4448470981,1,19,4,1,9,4,9,0,0,0,0,18738,7.0,18081,246,48,3660,577,24.6,1873.8,17,1,0,4,9,5,1,1,0,0,15078,6.8,17504,196,68,-3660,-577,19.6,1507.8
4522596312,1,54,1,1,15,2,15,1,1,0,0,19848,7.2,19712,224,52,5275,3662,22.4,1984.8,13,2,0,2,15,0,0,0,0,0,14573,6.6,16050,227,56,-5275,-3662,22.7,1457.3
4481862687,1,18,5,1,10,2,12,2,1,1,0,18912,7.0,17839,257,44,4565,2079,25.7,1891.2,19,4,0,2,10,2,0,0,0,0,14347,6.2,15760,197,52,-4565,-2079,19.7,1434.7
4440119391,1,24,3,1,14,4,14,0,0,0,0,21095,7.6,21242,249,67,5802,5396,24.9,2109.5,13,5,0,4,14,5,1,1,0,0,15293,6.2,15846,186,44,-5802,-5396,18.6,1529.3
4503150279,1,18,1,1,7,2,6,0,0,0,0,16647,7.0,18161,214,48,3257,2138,21.4,1664.7,27,2,0,2,7,1,0,0,0,0,13390,6.2,16023,197,44,-3257,-2138,19.7,1339.0
4484473320,1,19,2,1,5,4,5,0,0,0,0,15679,6.6,16202,224,36,812,237,22.4,1567.9,18,6,0,4,5,7,0,0,0,0,14867,6.4,15965,220,36,-812,-237,22.0,1486.7
4456261396,1,70,2,1,8,3,8,1,1,0,0,17166,7.4,20100,208,63,2027,2259,20.8,1716.6,13,4,0,3,8,1,0,0,0,0,15139,6.8,17841,218,48,-2027,-2259,21.8,1513.9
4526338952,1,18,3,1,7,10,11,1,1,0,0,16057,6.8,17123,187,60,-2259,-898,18.7,1605.7,14,1,0,10,7,14,0,0,0,0,18316,6.8,18021,227,32,2259,898,22.7,1831.6
4513809360,1,25,2,0,8,4,12,2,1,1,0,18167,7.0,18502,222,68,2691,2585,22.2,1816.7,16,2,1,4,8,4,0,0,0,0,15476,6.2,15917,234,41,-2691,-2585,23.4,1547.6
4508690422,1,18,2,0,11,5,11,0,0,0,0,18403,7.4,19486,239,48,2239,1539,23.9,1840.3,22,4,1,5,11,4,1,1,0,0,16164,6.6,17947,231,63,-2239,-1539,23.1,1616.4
4471429482,1,13,3,1,9,3,13,1,1,0,0,17939,7.2,18687,220,48,3246,409,22.0,1793.9,15,0,0,3,9,0,0,0,0,0,14693,7.0,18278,235,52,-3246,-409,23.5,1469.3
4498809510,1,46,1,0,1,8,0,1,0,1,0,14206,7.0,17314,218,64,-2855,-1603,21.8,1420.6,16,14,1,8,1,8,1,1,0,0,17061,7.0,18917,228,56,2855,1603,22.8,1706.1
4524264529,1,12,4,0,5,8,5,1,1,0,0,16245,7.0,17547,206,52,-1051,753,20.6,1624.5,18,2,1,8,5,11,0,0,0,0,17296,6.8,16794,206,48,1051,-753,20.6,1729.6
4503251133,1,16,4,0,8,7,7,0,0,0,0,16966,7.4,19266,228,55,705,2576,22.8,1696.6,16,4,1,7,8,5,1,1,0,0,16261,6.6,16690,198,47,-705,-2576,19.8,1626.1
4485702742,1,15,0,1,9,2,5,1,1,0,0,18079,7.2,19818,272,52,3854,2379,27.2,1807.9,15,1,0,2,9,1,0,0,0,0,14225,6.8,17439,230,41,-3854,-2379,23.0,1422.5
4475233251,1,24,5,1,9,8,8,1,0,1,0,18321,6.8,18428,230,46,2788,558,23.0,1832.1,18,0,0,8,9,5,0,0,0,0,15533,6.6,17870,183,47,-2788,-558,18.3,1553.3
4514457087,1,14,1,1,9,4,11,0,0,0,0,17494,7.0,18057,205,56,1518,-5,20.5,1749.4,13,0,0,4,9,5,1,1,0,0,15976,7.0,18062,199,72,-1518,5,19.9,1597.6
4424206558,1,17,1,1,7,8,10,1,1,0,0,16863,6.6,17727,216,48,106,-462,21.6,1686.3,14,0,0,8,7,9,0,0,0,0,16757,7.2,18189,184,52,-106,462,18.4,1675.7
4518606893,1,18,0,1,9,6,13,0,0,0,0,17855,7.2,19265,200,51,2063,2131,20.0,1785.5,39,2,0,6,9,10,1,1,0,0,15792,7.0,17134,182,42,-2063,-2131,18.2,1579.2
4468293476,1,25,1,1,3,3,4,0,0,0,0,15834,7.0,18253,248,52,324,-574,24.8,1583.4,9,2,0,3,3,3,2,1,1,0,15510,7.2,18827,220,68,-324,574,22.0,1551.0
4298114879,1,21,2,0,6,2,8,0,0,0,0,16818,6.8,16961,204,52,1448,-664,20.4,1681.8,19,4,1,2,6,2,1,1,0,0,15370,7.0,17625,250,60,-1448,664,25.0,1537.0
4524203497,1,13,2,1,6,3,5,2,1,1,0,17898,7.0,19735,238,67,3477,3386,23.8,1789.8,12,0,0,3,6,3,0,0,0,0,14421,6.6,16349,224,44,-3477,-3386,22.4,1442.1
4506306912,1,16,4,1,7,5,7,1,1,0,0,17106,7.2,18424,231,48,450,-219,23.1,1710.6,17,6,0,5,7,5,1,0,1,0,16656,7.0,18643,241,62,-450,219,24.1,1665.6
4391260446,1,43,5,0,10,7,11,2,1,1,0,17748,7.0,19116,206,43,1212,2099,20.6,1774.8,17,5,1,7,10,10,0,0,0,0,16536,7.0,17017,191,40,-1212,-2099,19.1,1653.6
4475586744,1,13,2,1,5,4,3,1,1,0,0,16261,7.2,19301,221,51,1320,839,22.1,1626.1,15,1,0,4,5,6,0,0,0,0,14941,7.0,18462,204,60,-1320,-839,20.4,1494.1
4443034912,1,14,0,1,12,4,5,1,0,1,2,20018,7.6,20654,226,44,6489,4212,22.6,2001.8,13,1,0,4,12,0,1,1,0,0,13529,6.6,16442,172,37,-6489,-4212,17.2,1352.9
4498832228,1,18,1,0,4,4,4,1,0,1,0,15381,6.8,17303,198,56,202,686,19.8,1538.1,14,4,1,4,4,6,0,0,0,0,15179,6.6,16617,214,38,-202,-686,21.4,1517.9
4519757776,1,14,2,0,4,3,3,1,1,0,0,15988,7.0,18515,251,52,623,640,25.1,1598.8,14,2,1,3,4,2,1,0,1,0,15365,7.0,17875,234,56,-623,-640,23.4,1536.5
4524326952,1,19,0,0,9,6,9,0,0,0,0,17368,6.8,18134,219,40,280,-1018,21.9,1736.8,15,3,1,6,9,8,0,0,0,0,17088,7.2,19152,227,59,-280,1018,22.7,1708.8
4525800444,1,69,3,1,9,3,11,0,0,0,0,16678,7.0,17929,201,42,1351,433,20.1,1667.8,13,2,0,3,9,6,1,1,0,0,15327,6.8,17496,228,62,-1351,-433,22.8,1532.7
4481146678,1,11,3,1,9,1,13,0,0,0,0,18297,7.2,19315,251,52,4796,3112,25.1,1829.7,12,1,0,1,9,0,0,0,0,0,13501,6.4,16203,203,53,-4796,-3112,20.3,1350.1
4468830390,1,25,2,0,14,9,16,1,1,0,0,19904,7.0,18106,179,60,2685,1605,17.9,1990.4,17,4,1,9,14,7,0,0,0,0,17219,6.6,16501,205,44,-2685,-1605,20.5,1721.9
4513963315,1,16,2,0,5,2,9,2,1,1,0,16636,7.0,19367,246,64,2547,1517,24.6,1663.6,15,1,1,2,5,0,0,0,0,0,14089,6.8,17850,215,56,-2547,-1517,21.5,1408.9
4500168780,1,18,3,1,10,6,12,2,1,1,1,19639,7.2,19616,241,57,2778,1130,24.1,1963.9,22,5,0,6,10,8,0,0,0,0,16861,7.2,18486,240,54,-2778,-1130,24.0,1686.1
4516544412,1,16,4,0,10,4,9,1,0,1,2,20236,7.0,18603,257,36,6161,5326,25.7,2023.6,12,1,1,4,10,6,1,1,0,0,14075,5.8,13277,146,40,-6161,-5326,14.6,1407.5
4526227837,1,15,2,0,11,7,9,0,0,0,0,19425,7.4,20998,218,67,3143,2852,21.8,1942.5,16,2,1,7,11,5,1,1,0,0,16282,7.0,18146,216,56,-3143,-2852,21.6,1628.2
4525051102,1,10,3,1,3,4,3,0,0,0,0,15482,6.8,17584,243,47,36,-928,24.3,1548.2,19,2,0,4,3,1,2,1,1,0,15446,7.2,18512,226,67,-36,928,22.6,1544.6
4519379201,1,53,2,0,7,17,5,0,0,0,0,15664,6.6,16740,174,48,-4732,-1805,17.4,1566.4,16,4,1,17,7,20,1,1,0,0,20396,7.0,18545,228,38,4732,1805,22.8,2039.6
4506553264,1,14,0,1,10,3,9,1,1,0,0,18096,7.2,19349,242,46,3738,4262,24.2,1809.6,11,4,0,3,10,4,0,0,0,0,14358,6.4,15087,198,47,-3738,-4262,19.8,1435.8
4495452428,1,16,2,0,8,9,7,1,1,0,0,17000,6.8,18009,190,60,-149,427,19.0,1700.0,15,3,1,9,8,8,0,0,0,0,17149,7.0,17582,211,48,149,-427,21.1,1714.9
4517689949,1,11,2,0,6,6,4,0,0,0,0,16556,7.2,18696,231,56,399,147,23.1,1655.6,15,1,1,6,6,4,2,1,1,0,16157,7.0,18549,239,54,-399,-147,23.9,1615.7
4519807061,1,18,3,0,12,4,16,1,1,0,0,19726,7.4,19180,246,48,5020,3785,24.6,1972.6,13,2,1,4,12,6,0,0,0,0,14706,6.4,15395,192,48,-5020,-3785,19.2,1470.6
4514193601,1,11,3,0,7,3,7,0,0,0,0,16464,7.2,18030,209,36,1474,963,20.9,1646.4,14,3,1,3,7,3,0,0,0,0,14990,6.6,17067,225,45,-1474,-963,22.5,1499.0
4526297055,1,19,2,0,11,4,10,1,1,0,0,18534,7.2,19784,208,56,2361,2489,20.8,1853.4,16,2,1,4,11,6,0,0,0,0,16173,6.8,17295,233,48,-2361,-2489,23.3,1617.3
4503813130,1,15,0,1,7,8,3,0,0,0,0,16058,7.0,17194,200,49,-535,1397,20.0,1605.8,14,1,0,8,7,5,1,1,0,0,16593,6.6,15797,198,40,535,-1397,19.8,1659.3
4467777075,1,15,4,1,8,4,8,1,1,0,0,17798,7.2,18795,220,56,3120,2464,22.0,1779.8,14,3,0,4,8,5,0,0,0,0,14678,6.6,16331,192,48,-3120,-2464,19.2,1467.8
4516748308,1,15,1,1,8,6,4,0,0,0,1,17706,6.8,18003,194,40,1893,763,19.4,1770.6,16,1,0,6,8,7,1,1,0,0,15813,6.6,17240,193,44,-1893,-763,19.3,1581.3
4481745211,1,28,7,0,6,9,7,0,0,0,0,15377,6.6,16348,177,43,-1871,-1775,17.7,1537.7,21,7,1,9,6,6,0,0,0,0,17248,7.0,18123,227,32,1871,1775,22.7,1724.8
4527673599,1,16,3,0,3,5,2,0,0,0,0,15125,6.6,17843,197,80,-712,977,19.7,1512.5,15,4,1,5,3,9,1,1,0,0,15837,6.8,16866,216,42,712,-977,21.6,1583.7
4520493215,1,54,5,1,5,1,9,0,0,0,0,15675,6.8,17474,198,48,994,-85,19.8,1567.5,15,2,0,1,5,1,1,1,0,0,14681,7.0,17559,243,66,-994,85,24.3,1468.1
4503460732,1,16,1,1,9,2,9,1,0,1,0,17665,7.4,19246,232,45,3642,2198,23.2,1766.5,81,3,0,2,9,1,1,1,0,0,14023,7.0,17048,199,46,-3642,-2198,19.9,1402.3
4519341811,1,42,1,1,12,5,10,0,0,0,0,19270,7.6,19668,229,55,3855,1646,22.9,1927.0,13,0,0,5,12,1,2,1,1,0,15415,7.0,18022,213,56,-3855,-1646,21.3,1541.5
4464561037,1,17,5,1,5,9,5,1,1,0,0,15585,6.6,16636,200,35,-2864,-3491,20.0,1558.5,18,3,0,9,5,8,0,0,0,0,18449,7.2,20127,224,71,2864,3491,22.4,1844.9
4508663861,1,15,3,0,6,6,6,0,0,0,0,15967,6.8,17567,222,56,-844,-640,22.2,1596.7,16,2,1,6,6,6,0,0,0,0,16811,7.0,18207,234,48,844,640,23.4,1681.1
4459817582,1,19,5,1,11,6,12,0,0,0,0,18354,6.8,17746,207,39,1775,-5,20.7,1835.4,37,5,0,6,11,3,0,0,0,0,16579,6.8,17751,208,54,-1775,5,20.8,1657.9
